ah	ah		UH
ahs	ahs		UH
alas	alas		UH
amen	amen		UH
aw	aw		UH
bam	bam		UH
boy	boy		UH
congratulations	congratulations		UH
damn	damn		UH
hello	hello		UH
hey	hey		UH
hi	hello		UH
howdy	howdy		UH
no	no		UH
nope	no		UH
oh	oh		UH
oink	oink		UH
oh	oh		UH
Oh	oh		UH
ok	okay		UH
OK	okay		UH
oohs	oohs		UH
please	please		UH
quack	quack		UH
true	true		UH
uh	uh		UH
uh-uh	uh-uh		UH
welcome	welcome		UH
well	well		UH
whoopee	whoopee		UH
wow	wow		UH
yeah	yes		UH
yes	yes		UH
zounds	zounds		UH
