aah	aah		VB
abacinate	abacinate		VB
abandon	abandon		VB
abase	abase		VB
abash	abash		VB
abate	abate		VB
abbreviate	abbreviate		VB
abdicate	abdicate		VB
abduce	abduce		VB
abduct	abduct		VB
aberrate	aberrate		VB
abet	abet		VB
abhor	abhor		VB
abide	abide		VB
abjure	abjure		VB
ablactate	ablactate		VB
ablate	ablate		VB
abnegate	abnegate		VB
abolish	abolish		VB
abominate	abominate		VB
abort	abort		VB
abound	abound		VB
about-face	about-face		VB
abrade	abrade		VB
abrase	abrase		VB
abreact	abreact		VB
abridge	abridge		VB
abrogate	abrogate		VB
abscise	abscise		VB
abscond	abscond		VB
abseil	abseil		VB
absent	absent		VB
absolve	absolve		VB
absorb	absorb		VB
absquatulate	absquatulate		VB
abstain	abstain		VB
abstract	abstract		VB
abuse	abuse		VB
abut	abut		VB
aby	aby		VB
abye	abye		VB
accede	accede		VB
accelerate	accelerate		VB
accent	accent		VB
accentuate	accentuate		VB
accept	accept		VB
access	access		VB
accession	accession		VB
acclaim	acclaim		VB
acclimate	acclimate		VB
acclimatise	acclimatise		VB
acclimatize	acclimatize		VB
accommodate	accommodate		VB
accompany	accompany		VB
accomplish	accomplish		VB
accord	accord		VB
accost	accost		VB
account	account		VB
accouter	accouter		VB
accoutre	accoutre		VB
accredit	accredit		VB
accrete	accrete		VB
accrue	accrue		VB
acculturate	acculturate		VB
accumulate	accumulate		VB
accurse	accurse		VB
accuse	accuse		VB
accustom	accustom		VB
ace	ace		VB
acerbate	acerbate		VB
acetify	acetify		VB
acetylate	acetylate		VB
acetylise	acetylise		VB
acetylize	acetylize		VB
ache	ache		VB
achieve	achieve		VB
achromatise	achromatise		VB
achromatize	achromatize		VB
acidify	acidify		VB
acidulate	acidulate		VB
acid-wash	acid-wash		VB
acknowledge	acknowledge		VB
acquaint	acquaint		VB
acquiesce	acquiesce		VB
acquire	acquire		VB
acquit	acquit		VB
act	act		VB
action	action		VB
activate	activate		VB
actualise	actualise		VB
actualize	actualize		VB
actuate	actuate		VB
acuminate	acuminate		VB
adapt	adapt		VB
add	add		VB
addict	addict		VB
addle	addle		VB
address	address		VB
adduce	adduce		VB
adduct	adduct		VB
adhere	adhere		VB
adjoin	adjoin		VB
adjourn	adjourn		VB
adjudge	adjudge		VB
adjudicate	adjudicate		VB
adjure	adjure		VB
adjust	adjust		VB
ad-lib	ad-lib		VB
admeasure	admeasure		VB
administer	administer		VB
administrate	administrate		VB
admire	admire		VB
admit	admit		VB
admix	admix		VB
admonish	admonish		VB
adolesce	adolesce		VB
adopt	adopt		VB
adore	adore		VB
adorn	adorn		VB
adsorb	adsorb		VB
adulate	adulate		VB
adulterate	adulterate		VB
adumbrate	adumbrate		VB
advance	advance		VB
advantage	advantage		VB
advect	advect		VB
adventure	adventure		VB
advert	advert		VB
advertise	advertise		VB
advertize	advertize		VB
advise	advise		VB
advocate	advocate		VB
aerate	aerate		VB
aerify	aerify		VB
aerosolise	aerosolise		VB
aerosolize	aerosolize		VB
aestivate	aestivate		VB
affect	affect		VB
affiance	affiance		VB
affiliate	affiliate		VB
affirm	affirm		VB
affix	affix		VB
afflict	afflict		VB
afford	afford		VB
afforest	afforest		VB
affranchise	affranchise		VB
affright	affright		VB
affront	affront		VB
age	age		VB
Agenise	Agenise		VB
Agenize	Agenize		VB
agglomerate	agglomerate		VB
agglutinate	agglutinate		VB
aggrade	aggrade		VB
aggrandise	aggrandise		VB
aggrandize	aggrandize		VB
aggravate	aggravate		VB
aggregate	aggregate		VB
aggress	aggress		VB
aggrieve	aggrieve		VB
aggroup	aggroup		VB
agitate	agitate		VB
agnise	agnise		VB
agnize	agnize		VB
agonise	agonise		VB
agonize	agonize		VB
agree	agree		VB
aid	aid		VB
ail	ail		VB
aim	aim		VB
air	air		VB
airbrush	airbrush		VB
air-condition	air-condition		VB
air-cool	air-cool		VB
air-drop	air-drop		VB
air-freight	air-freight		VB
airfreight	airfreight		VB
airlift	airlift		VB
airmail	airmail		VB
air-ship	air-ship		VB
air-slake	air-slake		VB
airt	airt		VB
alarm	alarm		VB
alchemise	alchemise		VB
alchemize	alchemize		VB
alcoholise	alcoholise		VB
alcoholize	alcoholize		VB
alert	alert		VB
alibi	alibi		VB
alien	alien		VB
alienate	alienate		VB
alight	alight		VB
align	align		VB
aliment	aliment		VB
aline	aline		VB
alkalify	alkalify		VB
alkalinise	alkalinise		VB
alkalinize	alkalinize		VB
alkalise	alkalise		VB
alkalize	alkalize		VB
allay	allay		VB
allege	allege		VB
allegorise	allegorise		VB
allegorize	allegorize		VB
alleviate	alleviate		VB
alligator	alligator		VB
alliterate	alliterate		VB
allocate	allocate		VB
allot	allot		VB
allow	allow		VB
allowance	allowance		VB
alloy	alloy		VB
allude	allude		VB
allure	allure		VB
ally	ally		VB
alphabetise	alphabetise		VB
alphabetize	alphabetize		VB
alter	alter		VB
altercate	altercate		VB
alternate	alternate		VB
aluminise	aluminise		VB
aluminize	aluminize		VB
amalgamate	amalgamate		VB
amass	amass		VB
amaze	amaze		VB
ambition	ambition		VB
amble	amble		VB
ambulate	ambulate		VB
ambuscade	ambuscade		VB
ambush	ambush		VB
ameliorate	ameliorate		VB
amend	amend		VB
amerce	amerce		VB
Americanise	Americanise		VB
Americanize	Americanize		VB
ammoniate	ammoniate		VB
ammonify	ammonify		VB
amnesty	amnesty		VB
amortise	amortise		VB
amortize	amortize		VB
amount	amount		VB
amplify	amplify		VB
amputate	amputate		VB
amuse	amuse		VB
anaesthetise	anaesthetise		VB
anaesthetize	anaesthetize		VB
anagram	anagram		VB
anagrammatise	anagrammatise		VB
anagrammatize	anagrammatize		VB
analogise	analogise		VB
analogize	analogize		VB
analyse	analyse		VB
analyze	analyze		VB
anastomose	anastomose		VB
anathematise	anathematise		VB
anathematize	anathematize		VB
anathemise	anathemise		VB
anathemize	anathemize		VB
anatomise	anatomise		VB
anatomize	anatomize		VB
anchor	anchor		VB
ancylose	ancylose		VB
anele	anele		VB
anesthetise	anesthetise		VB
anesthetize	anesthetize		VB
anger	anger		VB
angle	angle		VB
angle-park	angle-park		VB
anglicise	anglicise		VB
anglicize	anglicize		VB
anguish	anguish		VB
angulate	angulate		VB
animadvert	animadvert		VB
animalise	animalise		VB
animalize	animalize		VB
animate	animate		VB
animise	animise		VB
animize	animize		VB
ankylose	ankylose		VB
anneal	anneal		VB
annex	annex		VB
annihilate	annihilate		VB
annotate	annotate		VB
announce	announce		VB
annoy	annoy		VB
annul	annul		VB
annunciate	annunciate		VB
anodise	anodise		VB
anodize	anodize		VB
anoint	anoint		VB
answer	answer		VB
antagonise	antagonise		VB
antagonize	antagonize		VB
ante	ante		VB
antecede	antecede		VB
antedate	antedate		VB
anthologise	anthologise		VB
anthologize	anthologize		VB
anthropomorphise	anthropomorphise		VB
anthropomorphize	anthropomorphize		VB
antic	antic		VB
anticipate	anticipate		VB
antiquate	antiquate		VB
antique	antique		VB
antisepticize	antisepticize		VB
ape	ape		VB
aphorise	aphorise		VB
aphorize	aphorize		VB
apologise	apologise		VB
apologize	apologize		VB
apostatise	apostatise		VB
apostatize	apostatize		VB
apostrophise	apostrophise		VB
apostrophize	apostrophize		VB
apotheose	apotheose		VB
apotheosise	apotheosise		VB
apotheosize	apotheosize		VB
appal	appal		VB
appall	appall		VB
apparel	apparel		VB
appeal	appeal		VB
appear	appear		VB
appease	appease		VB
append	append		VB
apperceive	apperceive		VB
appertain	appertain		VB
applaud	applaud		VB
applique	applique		VB
apply	apply		VB
appoint	appoint		VB
apportion	apportion		VB
appose	appose		VB
appraise	appraise		VB
appreciate	appreciate		VB
apprehend	apprehend		VB
apprentice	apprentice		VB
apprise	apprise		VB
apprize	apprize		VB
approach	approach		VB
approbate	approbate		VB
appropriate	appropriate		VB
approve	approve		VB
approximate	approximate		VB
aquaplane	aquaplane		VB
aquatint	aquatint		VB
arbitrage	arbitrage		VB
arbitrate	arbitrate		VB
arborise	arborise		VB
arborize	arborize		VB
arc	arc		VB
archaise	archaise		VB
archaize	archaize		VB
arch	arch		VB
archive	archive		VB
argue	argue		VB
argufy	argufy		VB
arise	arise		VB
arm	arm		VB
armor	armor		VB
armour	armour		VB
aromatise	aromatise		VB
aromatize	aromatize		VB
arouse	arouse		VB
arraign	arraign		VB
arrange	arrange		VB
array	array		VB
arrest	arrest		VB
arrive	arrive		VB
arrogate	arrogate		VB
arterialise	arterialise		VB
arterialize	arterialize		VB
article	article		VB
articulate	articulate		VB
ascend	ascend		VB
ascertain	ascertain		VB
ascribe	ascribe		VB
ash	ash		VB
ask	ask		VB
asperse	asperse		VB
asphalt	asphalt		VB
asphyxiate	asphyxiate		VB
aspirate	aspirate		VB
aspire	aspire		VB
assail	assail		VB
assassinate	assassinate		VB
assault	assault		VB
assay	assay		VB
assemble	assemble		VB
assent	assent		VB
assert	assert		VB
assess	assess		VB
asseverate	asseverate		VB
assibilate	assibilate		VB
assign	assign		VB
assimilate	assimilate		VB
assist	assist		VB
associate	associate		VB
assoil	assoil		VB
assonate	assonate		VB
assort	assort		VB
assuage	assuage		VB
assume	assume		VB
assure	assure		VB
asterisk	asterisk		VB
astonish	astonish		VB
astound	astound		VB
astringe	astringe		VB
astrogate	astrogate		VB
atom-bomb	atom-bomb		VB
atomise	atomise		VB
atomize	atomize		VB
atone	atone		VB
atrophy	atrophy		VB
attach	attach		VB
attack	attack		VB
attain	attain		VB
attaint	attaint		VB
attemper	attemper		VB
attempt	attempt		VB
attend	attend		VB
attenuate	attenuate		VB
attest	attest		VB
attire	attire		VB
attitudinise	attitudinise		VB
attitudinize	attitudinize		VB
attorn	attorn		VB
attract	attract		VB
attribute	attribute		VB
attune	attune		VB
auction	auction		VB
auctioneer	auctioneer		VB
audit	audit		VB
audition	audition		VB
augment	augment		VB
augur	augur		VB
aurify	aurify		VB
auscultate	auscultate		VB
auspicate	auspicate		VB
authenticate	authenticate		VB
author	author		VB
authorise	authorise		VB
authorize	authorize		VB
autoclave	autoclave		VB
autograph	autograph		VB
automate	automate		VB
automatise	automatise		VB
automatize	automatize		VB
automobile	automobile		VB
autopsy	autopsy		VB
autotomise	autotomise		VB
autotomize	autotomize		VB
avail	avail		VB
avalanche	avalanche		VB
avenge	avenge		VB
average	average		VB
aver	aver		VB
avert	avert		VB
avianise	avianise		VB
avianize	avianize		VB
aviate	aviate		VB
avoid	avoid		VB
avouch	avouch		VB
avow	avow		VB
avulse	avulse		VB
await	await		VB
awake	awake		VB
awaken	awaken		VB
award	award		VB
awe	awe		VB
ax	ax		VB
axe	axe		VB
azure	azure		VB
baa	baa		VB
babbitt	babbitt		VB
babble	babble		VB
baby	baby		VB
baby-sit	baby-sit		VB
bach	bach		VB
bachelor	bachelor		VB
back	back		VB
backbite	backbite		VB
backcross	backcross		VB
backdate	backdate		VB
backfire	backfire		VB
background	background		VB
backhand	backhand		VB
backlash	backlash		VB
backlog	backlog		VB
backpack	backpack		VB
backpedal	backpedal		VB
backscatter	backscatter		VB
backslap	backslap		VB
backslide	backslide		VB
backspace	backspace		VB
backstitch	backstitch		VB
backstop	backstop		VB
backstroke	backstroke		VB
backtrack	backtrack		VB
bacterise	bacterise		VB
bacterize	bacterize		VB
badge	badge		VB
badger	badger		VB
badmouth	badmouth		VB
baffle	baffle		VB
bag	bag		VB
bail	bail		VB
bait	bait		VB
bake	bake		VB
balance	balance		VB
bald	bald		VB
bale	bale		VB
Balkanise	Balkanise		VB
Balkanize	Balkanize		VB
balk	balk		VB
ballast	ballast		VB
ball	ball		VB
balloon	balloon		VB
ballot	ballot		VB
ballyhoo	ballyhoo		VB
ballyrag	ballyrag		VB
bamboozle	bamboozle		VB
ban	ban		VB
bandage	bandage		VB
band	band		VB
bandy	bandy		VB
bang	bang		VB
banish	banish		VB
bank	bank		VB
bankroll	bankroll		VB
bankrupt	bankrupt		VB
banquet	banquet		VB
banter	banter		VB
baptise	baptise		VB
baptize	baptize		VB
barbarise	barbarise		VB
barbarize	barbarize		VB
bar	bar		VB
barb	barb		VB
barbecue	barbecue		VB
barbeque	barbeque		VB
barber	barber		VB
bard	bard		VB
barde	barde		VB
bare	bare		VB
barf	barf		VB
bargain	bargain		VB
barge	barge		VB
bark	bark		VB
barnstorm	barnstorm		VB
baronetise	baronetise		VB
baronetize	baronetize		VB
barrack	barrack		VB
barrage	barrage		VB
barrel	barrel		VB
barricade	barricade		VB
barricado	barricado		VB
barter	barter		VB
base	base		VB
bash	bash		VB
basify	basify		VB
bask	bask		VB
basset	basset		VB
bastardise	bastardise		VB
bastardize	bastardize		VB
baste	baste		VB
bastinado	bastinado		VB
bat	bat		VB
batch	batch		VB
bate	bate		VB
batfowl	batfowl		VB
bath	bath		VB
bathe	bathe		VB
batik	batik		VB
batten	batten		VB
batter	batter		VB
battle	battle		VB
baulk	baulk		VB
bawl	bawl		VB
bay	bay		VB
bayonet	bayonet		VB
beach	beach		VB
beacon	beacon		VB
bead	bead		VB
beak	beak		VB
beam	beam		VB
bean	bean		VB
bear	bear		VB
beard	beard		VB
beat	beat		VB
beatify	beatify		VB
beautify	beautify		VB
beaver	beaver		VB
be	be		VB
bebop	bebop		VB
becalm	becalm		VB
bechance	bechance		VB
becharm	becharm		VB
beckon	beckon		VB
becloud	becloud		VB
become	become		VB
bedamn	bedamn		VB
bedaub	bedaub		VB
bedaze	bedaze		VB
bedazzle	bedazzle		VB
bed	bed		VB
bedeck	bedeck		VB
bedevil	bedevil		VB
bedew	bedew		VB
bed-hop	bed-hop		VB
bedhop	bedhop		VB
bedight	bedight		VB
bedim	bedim		VB
bedizen	bedizen		VB
bedraggle	bedraggle		VB
beef	beef		VB
beep	beep		VB
beeswax	beeswax		VB
beetle	beetle		VB
befall	befall		VB
befit	befit		VB
befog	befog		VB
befool	befool		VB
befoul	befoul		VB
befriend	befriend		VB
befuddle	befuddle		VB
beg	beg		VB
beget	beget		VB
beggar	beggar		VB
begild	begild		VB
begin	begin		VB
begrime	begrime		VB
begrudge	begrudge		VB
beguile	beguile		VB
behave	behave		VB
behead	behead		VB
behold	behold		VB
behoove	behoove		VB
behove	behove		VB
bejewel	bejewel		VB
belabor	belabor		VB
belabour	belabour		VB
belay	belay		VB
belch	belch		VB
beleaguer	beleaguer		VB
belie	belie		VB
believe	believe		VB
belittle	belittle		VB
bell	bell		VB
bellow	bellow		VB
bellyache	bellyache		VB
belly	belly		VB
belly-flop	belly-flop		VB
belly-land	belly-land		VB
bellylaugh	bellylaugh		VB
belong	belong		VB
belt	belt		VB
bemire	bemire		VB
bemoan	bemoan		VB
bemock	bemock		VB
bemuse	bemuse		VB
bench	bench		VB
benday	benday		VB
bend	bend		VB
benefact	benefact		VB
benefice	benefice		VB
beneficiate	beneficiate		VB
benefit	benefit		VB
benficiate	benficiate		VB
benight	benight		VB
benumb	benumb		VB
beplaster	beplaster		VB
bequeath	bequeath		VB
berate	berate		VB
bereave	bereave		VB
berry	berry		VB
berth	berth		VB
beseech	beseech		VB
beseem	beseem		VB
beset	beset		VB
beshrew	beshrew		VB
besiege	besiege		VB
besmear	besmear		VB
besmirch	besmirch		VB
besot	besot		VB
bespangle	bespangle		VB
bespatter	bespatter		VB
bespeak	bespeak		VB
bespeckle	bespeckle		VB
bespot	bespot		VB
besprinkle	besprinkle		VB
best	best		VB
bestialise	bestialise		VB
bestialize	bestialize		VB
bestir	bestir		VB
bestow	bestow		VB
bestrew	bestrew		VB
bestride	bestride		VB
bet	bet		VB
bethink	bethink		VB
betide	betide		VB
betoken	betoken		VB
betray	betray		VB
betroth	betroth		VB
better	better		VB
bevel	bevel		VB
bewail	bewail		VB
beware	beware		VB
bewhisker	bewhisker		VB
bewilder	bewilder		VB
bewitch	bewitch		VB
bewray	bewray		VB
bias	bias		VB
bib	bib		VB
bicker	bicker		VB
bicycle	bicycle		VB
bid	bid		VB
bide	bide		VB
biff	biff		VB
bifurcate	bifurcate		VB
bight	bight		VB
bike	bike		VB
bilge	bilge		VB
bilk	bilk		VB
bill	bill		VB
billet	billet		VB
billow	billow		VB
bin	bin		VB
bind	bind		VB
binge	binge		VB
bioassay	bioassay		VB
biodegrade	biodegrade		VB
birch	birch		VB
bird	bird		VB
birdie	birdie		VB
birdlime	birdlime		VB
bird-nest	bird-nest		VB
birdnest	birdnest		VB
birdwatch	birdwatch		VB
birl	birl		VB
birle	birle		VB
birr	birr		VB
birth	birth		VB
bisect	bisect		VB
bitch	bitch		VB
bite	bite		VB
bitt	bitt		VB
bitter	bitter		VB
bituminise	bituminise		VB
bituminize	bituminize		VB
bivouac	bivouac		VB
blabber	blabber		VB
blab	blab		VB
blackball	blackball		VB
blackberry	blackberry		VB
black	black		VB
blacken	blacken		VB
blackguard	blackguard		VB
blackjack	blackjack		VB
blacklead	blacklead		VB
blackleg	blackleg		VB
blacklist	blacklist		VB
blackmail	blackmail		VB
blacktop	blacktop		VB
blackwash	blackwash		VB
blame	blame		VB
blanch	blanch		VB
blandish	blandish		VB
blank	blank		VB
blanket	blanket		VB
blare	blare		VB
blarney	blarney		VB
blaspheme	blaspheme		VB
blast	blast		VB
blat	blat		VB
blate	blate		VB
blather	blather		VB
blaze	blaze		VB
blazon	blazon		VB
bleach	bleach		VB
blear	blear		VB
bleat	bleat		VB
bleed	bleed		VB
bleep	bleep		VB
blemish	blemish		VB
blench	blench		VB
blend	blend		VB
bless	bless		VB
blether	blether		VB
blight	blight		VB
blind	blind		VB
blindfold	blindfold		VB
blindside	blindside		VB
blink	blink		VB
blinker	blinker		VB
blister	blister		VB
blither	blither		VB
blitz	blitz		VB
blitzkrieg	blitzkrieg		VB
bloat	bloat		VB
blob	blob		VB
blockade	blockade		VB
block	block		VB
blog	blog		VB
blood	blood		VB
bloody	bloody		VB
bloom	bloom		VB
blossom	blossom		VB
blot	blot		VB
blotch	blotch		VB
bloviate	bloviate		VB
blow	blow		VB
blow-dry	blow-dry		VB
blubber	blubber		VB
blub	blub		VB
bludgeon	bludgeon		VB
blue	blue		VB
blue-pencil	blue-pencil		VB
blueprint	blueprint		VB
bluff	bluff		VB
blunder	blunder		VB
blunt	blunt		VB
blur	blur		VB
blurt	blurt		VB
blush	blush		VB
bluster	bluster		VB
board	board		VB
boast	boast		VB
boat	boat		VB
boat-race	boat-race		VB
bobble	bobble		VB
bob	bob		VB
bobsled	bobsled		VB
bode	bode		VB
bodge	bodge		VB
body	body		VB
bodypaint	bodypaint		VB
body-surf	body-surf		VB
bog	bog		VB
bogey	bogey		VB
boggle	boggle		VB
boil	boil		VB
boldface	boldface		VB
bollix	bollix		VB
bollocks	bollocks		VB
bolshevise	bolshevise		VB
bolshevize	bolshevize		VB
bolster	bolster		VB
bolt	bolt		VB
bombard	bombard		VB
bomb	bomb		VB
bombilate	bombilate		VB
bombinate	bombinate		VB
bombproof	bombproof		VB
bond	bond		VB
bonderise	bonderise		VB
bonderize	bonderize		VB
bone	bone		VB
bong	bong		VB
bonk	bonk		VB
bonnet	bonnet		VB
boob	boob		VB
boo	boo		VB
boogie	boogie		VB
book	book		VB
boom	boom		VB
boomerang	boomerang		VB
boondoggle	boondoggle		VB
boost	boost		VB
boot	boot		VB
bootleg	bootleg		VB
bootlick	bootlick		VB
bootstrap	bootstrap		VB
booze	booze		VB
bop	bop		VB
border	border		VB
bore	bore		VB
borrow	borrow		VB
bosom	bosom		VB
boss	boss		VB
botanise	botanise		VB
botanize	botanize		VB
botch	botch		VB
bother	bother		VB
bottle	bottle		VB
bottlefeed	bottlefeed		VB
bottleneck	bottleneck		VB
bottom	bottom		VB
bounce	bounce		VB
bound	bound		VB
bourgeon	bourgeon		VB
bouse	bouse		VB
bow	bow		VB
bowdlerise	bowdlerise		VB
bowdlerize	bowdlerize		VB
bower	bower		VB
bowl	bowl		VB
bowse	bowse		VB
box	box		VB
boycott	boycott		VB
brabble	brabble		VB
brace	brace		VB
brachiate	brachiate		VB
bracket	bracket		VB
brad	brad		VB
brag	brag		VB
braid	braid		VB
brail	brail		VB
braille	braille		VB
brain	brain		VB
brainstorm	brainstorm		VB
brainwash	brainwash		VB
braise	braise		VB
brake	brake		VB
branch	branch		VB
brand	brand		VB
brandish	brandish		VB
brandmark	brandmark		VB
brattice	brattice		VB
brattle	brattle		VB
brave	brave		VB
bravo	bravo		VB
brawl	brawl		VB
bray	bray		VB
braze	braze		VB
brazen	brazen		VB
breach	breach		VB
bread	bread		VB
break	break		VB
break-dance	break-dance		VB
breakfast	breakfast		VB
bream	bream		VB
breast	breast		VB
breastfeed	breastfeed		VB
breaststroke	breaststroke		VB
breathalyse	breathalyse		VB
breathalyze	breathalyze		VB
breathe	breathe		VB
brecciate	brecciate		VB
breed	breed		VB
breeze	breeze		VB
brevet	brevet		VB
brew	brew		VB
bribe	bribe		VB
bridge	bridge		VB
bridle	bridle		VB
brief	brief		VB
brigade	brigade		VB
brighten	brighten		VB
brim	brim		VB
brine	brine		VB
bring	bring		VB
brisk	brisk		VB
brisken	brisken		VB
bristle	bristle		VB
broach	broach		VB
broadcast	broadcast		VB
broaden	broaden		VB
broadside	broadside		VB
brocade	brocade		VB
broider	broider		VB
broil	broil		VB
broker	broker		VB
bromate	bromate		VB
brominate	brominate		VB
bronze	bronze		VB
brooch	brooch		VB
brood	brood		VB
brook	brook		VB
broom	broom		VB
browbeat	browbeat		VB
brown	brown		VB
brown-nose	brown-nose		VB
browse	browse		VB
bruise	bruise		VB
bruit	bruit		VB
brunch	brunch		VB
brush	brush		VB
brutalise	brutalise		VB
brutalize	brutalize		VB
bubble	bubble		VB
buccaneer	buccaneer		VB
buck	buck		VB
bucket	bucket		VB
buckle	buckle		VB
buckram	buckram		VB
bud	bud		VB
budge	budge		VB
budget	budget		VB
buffalo	buffalo		VB
buff	buff		VB
buffer	buffer		VB
buffet	buffet		VB
bug	bug		VB
bugger	bugger		VB
bugle	bugle		VB
build	build		VB
bulge	bulge		VB
bulk	bulk		VB
bull	bull		VB
bulldog	bulldog		VB
bulldoze	bulldoze		VB
bulletin	bulletin		VB
bulletproof	bulletproof		VB
bullshit	bullshit		VB
bully	bully		VB
bullyrag	bullyrag		VB
bulwark	bulwark		VB
bumble	bumble		VB
bum	bum		VB
bump	bump		VB
bunch	bunch		VB
bunco	bunco		VB
bundle	bundle		VB
bung	bung		VB
bungle	bungle		VB
bunk	bunk		VB
bunker	bunker		VB
bunt	bunt		VB
buoy	buoy		VB
burble	burble		VB
bur	bur		VB
burden	burden		VB
burgeon	burgeon		VB
burglarise	burglarise		VB
burglarize	burglarize		VB
burgle	burgle		VB
burke	burke		VB
burl	burl		VB
burlesque	burlesque		VB
burn	burn		VB
burnish	burnish		VB
burp	burp		VB
burr	burr		VB
burrow	burrow		VB
burst	burst		VB
burthen	burthen		VB
bury	bury		VB
bus	bus		VB
bush	bush		VB
bushel	bushel		VB
bushwhack	bushwhack		VB
busk	busk		VB
buss	buss		VB
bust	bust		VB
bustle	bustle		VB
busy	busy		VB
butcher	butcher		VB
butt	butt		VB
butter	butter		VB
butterfly	butterfly		VB
button	button		VB
buttonhole	buttonhole		VB
buttress	buttress		VB
butt-weld	butt-weld		VB
buttweld	buttweld		VB
butylate	butylate		VB
buy	buy		VB
buzz	buzz		VB
by-bid	by-bid		VB
bypass	bypass		VB
cabal	cabal		VB
cabbage	cabbage		VB
cab	cab		VB
cabin	cabin		VB
cable	cable		VB
ca-ca	ca-ca		VB
cache	cache		VB
cachinnate	cachinnate		VB
cackel	cackel		VB
cackle	cackle		VB
caddie	caddie		VB
caddy	caddy		VB
cadge	cadge		VB
cage	cage		VB
cajole	cajole		VB
cake	cake		VB
cakewalk	cakewalk		VB
calcify	calcify		VB
calcimine	calcimine		VB
calcine	calcine		VB
calculate	calculate		VB
calendar	calendar		VB
calender	calender		VB
calibrate	calibrate		VB
caliper	caliper		VB
calk	calk		VB
call	call		VB
calligraph	calligraph		VB
calliper	calliper		VB
callous	callous		VB
callus	callus		VB
calm	calm		VB
calumniate	calumniate		VB
calve	calve		VB
camber	camber		VB
camouflage	camouflage		VB
campaign	campaign		VB
camp	camp		VB
camphorate	camphorate		VB
canal	canal		VB
canalise	canalise		VB
canalize	canalize		VB
can	can		VB
cancel	cancel		VB
candle	candle		VB
candy	candy		VB
cane	cane		VB
canker	canker		VB
cannibalise	cannibalise		VB
cannibalize	cannibalize		VB
cannonade	cannonade		VB
cannon	cannon		VB
cannulate	cannulate		VB
cannulise	cannulise		VB
cannulize	cannulize		VB
canoe	canoe		VB
canonise	canonise		VB
canonize	canonize		VB
canoodle	canoodle		VB
canopy	canopy		VB
cant	cant		VB
canter	canter		VB
cantilever	cantilever		VB
cantillate	cantillate		VB
canton	canton		VB
canulate	canulate		VB
canvas	canvas		VB
canvass	canvass		VB
capacitate	capacitate		VB
caparison	caparison		VB
cap	cap		VB
caper	caper		VB
capitalise	capitalise		VB
capitalize	capitalize		VB
capitulate	capitulate		VB
caponise	caponise		VB
caponize	caponize		VB
capriole	capriole		VB
capsize	capsize		VB
capsulate	capsulate		VB
capsule	capsule		VB
capsulise	capsulise		VB
capsulize	capsulize		VB
captain	captain		VB
caption	caption		VB
captivate	captivate		VB
capture	capture		VB
caracole	caracole		VB
caramelise	caramelise		VB
caramelize	caramelize		VB
caravan	caravan		VB
carbonate	carbonate		VB
carbonise	carbonise		VB
carbonize	carbonize		VB
carboxylate	carboxylate		VB
carburet	carburet		VB
carburise	carburise		VB
carburize	carburize		VB
card	card		VB
care	care		VB
careen	careen		VB
career	career		VB
caress	caress		VB
caricature	caricature		VB
carjack	carjack		VB
cark	cark		VB
carmine	carmine		VB
carnalise	carnalise		VB
carnalize	carnalize		VB
carnify	carnify		VB
carol	carol		VB
carom	carom		VB
carouse	carouse		VB
carp	carp		VB
carpenter	carpenter		VB
carpet	carpet		VB
carry	carry		VB
cart	cart		VB
cartoon	cartoon		VB
cartwheel	cartwheel		VB
carve	carve		VB
cascade	cascade		VB
caseate	caseate		VB
case	case		VB
cash	cash		VB
cashier	cashier		VB
casket	casket		VB
cast	cast		VB
castigate	castigate		VB
castle	castle		VB
castrate	castrate		VB
catabolise	catabolise		VB
catabolize	catabolize		VB
catalog	catalog		VB
catalogue	catalogue		VB
catalyse	catalyse		VB
catalyze	catalyze		VB
catapult	catapult		VB
catcall	catcall		VB
cat	cat		VB
catch	catch		VB
catechise	catechise		VB
catechize	catechize		VB
categorise	categorise		VB
categorize	categorize		VB
catenate	catenate		VB
catenulate	catenulate		VB
cater	cater		VB
caterwaul	caterwaul		VB
cathect	cathect		VB
catheterise	catheterise		VB
catheterize	catheterize		VB
catholicise	catholicise		VB
catholicize	catholicize		VB
catnap	catnap		VB
caucus	caucus		VB
caulk	caulk		VB
cause	cause		VB
causeway	causeway		VB
cauterise	cauterise		VB
cauterize	cauterize		VB
caution	caution		VB
cave	cave		VB
cavern	cavern		VB
cavil	cavil		VB
cavort	cavort		VB
caw	caw		VB
cease	cease		VB
cede	cede		VB
celebrate	celebrate		VB
cement	cement		VB
cense	cense		VB
censor	censor		VB
censure	censure		VB
census	census		VB
center	center		VB
centralise	centralise		VB
centralize	centralize		VB
centre	centre		VB
centrifugate	centrifugate		VB
centrifuge	centrifuge		VB
cerebrate	cerebrate		VB
cere	cere		VB
certificate	certificate		VB
certify	certify		VB
cha-cha	cha-cha		VB
chafe	chafe		VB
chaff	chaff		VB
chaffer	chaffer		VB
chagrin	chagrin		VB
chain	chain		VB
chain-smoke	chain-smoke		VB
chair	chair		VB
chairman	chairman		VB
chalk	chalk		VB
challenge	challenge		VB
chamber	chamber		VB
chamfer	chamfer		VB
champ	champ		VB
champion	champion		VB
chance	chance		VB
chandelle	chandelle		VB
change	change		VB
channel	channel		VB
channelise	channelise		VB
channelize	channelize		VB
channel-surf	channel-surf		VB
chant	chant		VB
chap	chap		VB
chaperon	chaperon		VB
chaperone	chaperone		VB
character	character		VB
characterise	characterise		VB
characterize	characterize		VB
char	char		VB
charcoal	charcoal		VB
charge	charge		VB
chariot	chariot		VB
Charleston	Charleston		VB
charm	charm		VB
chart	chart		VB
charter	charter		VB
chase	chase		VB
chasse	chasse		VB
chasten	chasten		VB
chastise	chastise		VB
chat	chat		VB
chatter	chatter		VB
chauffeur	chauffeur		VB
chaw	chaw		VB
cheapen	cheapen		VB
cheat	cheat		VB
check	check		VB
checker	checker		VB
checkmate	checkmate		VB
checkrow	checkrow		VB
cheek	cheek		VB
cheep	cheep		VB
cheer	cheer		VB
cheerlead	cheerlead		VB
cheese	cheese		VB
chelate	chelate		VB
chemisorb	chemisorb		VB
cheque	cheque		VB
chequer	chequer		VB
cherish	cherish		VB
chevvy	chevvy		VB
chevy	chevy		VB
chew	chew		VB
chicane	chicane		VB
chicken-fight	chicken-fight		VB
chickenfight	chickenfight		VB
chide	chide		VB
child-proof	child-proof		VB
childproof	childproof		VB
chill	chill		VB
chime	chime		VB
chin	chin		VB
chine	chine		VB
chink	chink		VB
chip	chip		VB
chirk	chirk		VB
chiromance	chiromance		VB
chirp	chirp		VB
chirr	chirr		VB
chirrup	chirrup		VB
chisel	chisel		VB
chit-chat	chit-chat		VB
chitchat	chitchat		VB
chitter	chitter		VB
chivvy	chivvy		VB
chivy	chivy		VB
chlorinate	chlorinate		VB
chloroform	chloroform		VB
chock	chock		VB
choir	choir		VB
choke	choke		VB
chomp	chomp		VB
chondrify	chondrify		VB
choose	choose		VB
chop	chop		VB
chord	chord		VB
choreograph	choreograph		VB
chortle	chortle		VB
chorus	chorus		VB
chouse	chouse		VB
christen	christen		VB
Christianise	Christianise		VB
Christianize	Christianize		VB
chrome	chrome		VB
chromium-plate	chromium-plate		VB
chronicle	chronicle		VB
chronologise	chronologise		VB
chronologize	chronologize		VB
chuck	chuck		VB
chuckle	chuckle		VB
chuff	chuff		VB
chug	chug		VB
chunk	chunk		VB
church	church		VB
churn	churn		VB
churr	churr		VB
chute	chute		VB
cicatrise	cicatrise		VB
cicatrize	cicatrize		VB
cinch	cinch		VB
cinematise	cinematise		VB
cinematize	cinematize		VB
cipher	cipher		VB
circle	circle		VB
circuit	circuit		VB
circularise	circularise		VB
circularize	circularize		VB
circulate	circulate		VB
circumambulate	circumambulate		VB
circumcise	circumcise		VB
circumfuse	circumfuse		VB
circumnavigate	circumnavigate		VB
circumscribe	circumscribe		VB
circumstantiate	circumstantiate		VB
circumvallate	circumvallate		VB
circumvent	circumvent		VB
circumvolute	circumvolute		VB
circumvolve	circumvolve		VB
cite	cite		VB
citify	citify		VB
citrate	citrate		VB
civilise	civilise		VB
civilize	civilize		VB
clabber	clabber		VB
clack	clack		VB
claim	claim		VB
clamber	clamber		VB
clam	clam		VB
clamor	clamor		VB
clamour	clamour		VB
clamp	clamp		VB
clang	clang		VB
clangor	clangor		VB
clangour	clangour		VB
clank	clank		VB
clapboard	clapboard		VB
clap	clap		VB
clapperclaw	clapperclaw		VB
claret	claret		VB
clarify	clarify		VB
clarion	clarion		VB
clash	clash		VB
clasp	clasp		VB
class	class		VB
classicise	classicise		VB
classicize	classicize		VB
classify	classify		VB
clatter	clatter		VB
claver	claver		VB
claw	claw		VB
claxon	claxon		VB
clean	clean		VB
cleanse	cleanse		VB
clear	clear		VB
clear-cut	clear-cut		VB
cleat	cleat		VB
cleave	cleave		VB
clench	clench		VB
clerk	clerk		VB
clew	clew		VB
click	click		VB
climax	climax		VB
climb	climb		VB
clinch	clinch		VB
cling	cling		VB
clink	clink		VB
clinker	clinker		VB
clip	clip		VB
clitter	clitter		VB
cloak	cloak		VB
clobber	clobber		VB
clock	clock		VB
clog	clog		VB
cloister	cloister		VB
clomp	clomp		VB
clone	clone		VB
clop	clop		VB
close	close		VB
closet	closet		VB
closure	closure		VB
clot	clot		VB
clothe	clothe		VB
cloture	cloture		VB
cloud	cloud		VB
clout	clout		VB
clown	clown		VB
cloy	cloy		VB
club	club		VB
cluck	cluck		VB
clue	clue		VB
clump	clump		VB
clunk	clunk		VB
cluster	cluster		VB
clutch	clutch		VB
clutter	clutter		VB
coach	coach		VB
coact	coact		VB
coagulate	coagulate		VB
coal	coal		VB
coalesce	coalesce		VB
coapt	coapt		VB
coarsen	coarsen		VB
coast	coast		VB
coat	coat		VB
co-author	co-author		VB
coax	coax		VB
cobble	cobble		VB
cobblestone	cobblestone		VB
cocainise	cocainise		VB
cocainize	cocainize		VB
cock	cock		VB
cocker	cocker		VB
cockle	cockle		VB
coconspire	coconspire		VB
cocoon	cocoon		VB
cod	cod		VB
coddle	coddle		VB
code	code		VB
codify	codify		VB
co-educate	co-educate		VB
coeducate	coeducate		VB
coerce	coerce		VB
coexist	coexist		VB
coffin	coffin		VB
cog	cog		VB
coggle	coggle		VB
cogitate	cogitate		VB
cognise	cognise		VB
cognize	cognize		VB
cohabit	cohabit		VB
cohere	cohere		VB
coif	coif		VB
coiffe	coiffe		VB
coiffure	coiffure		VB
coil	coil		VB
coincide	coincide		VB
coin	coin		VB
coinsure	coinsure		VB
coke	coke		VB
coldcock	coldcock		VB
cold-cream	cold-cream		VB
cold-shoulder	cold-shoulder		VB
coldwork	coldwork		VB
collaborate	collaborate		VB
collapse	collapse		VB
collar	collar		VB
collate	collate		VB
collateralize	collateralize		VB
collect	collect		VB
collectivise	collectivise		VB
collectivize	collectivize		VB
collide	collide		VB
colligate	colligate		VB
collimate	collimate		VB
collocate	collocate		VB
collogue	collogue		VB
collude	collude		VB
colly	colly		VB
colonise	colonise		VB
colonize	colonize		VB
colorcast	colorcast		VB
color	color		VB
colorise	colorise		VB
colorize	colorize		VB
colour	colour		VB
colourise	colourise		VB
colourize	colourize		VB
combat	combat		VB
comb	comb		VB
combine	combine		VB
combust	combust		VB
come	come		VB
comfit	comfit		VB
comfort	comfort		VB
command	command		VB
commandeer	commandeer		VB
commemorate	commemorate		VB
commence	commence		VB
commend	commend		VB
commentate	commentate		VB
comment	comment		VB
commercialise	commercialise		VB
commercialize	commercialize		VB
comminate	comminate		VB
commingle	commingle		VB
comminute	comminute		VB
commiserate	commiserate		VB
commission	commission		VB
commit	commit		VB
commix	commix		VB
commove	commove		VB
communalise	communalise		VB
communalize	communalize		VB
commune	commune		VB
communicate	communicate		VB
communise	communise		VB
communize	communize		VB
commutate	commutate		VB
commute	commute		VB
compact	compact		VB
companion	companion		VB
company	company		VB
compare	compare		VB
comparison-shop	comparison-shop		VB
compart	compart		VB
compartmentalise	compartmentalise		VB
compartmentalize	compartmentalize		VB
compass	compass		VB
compassionate	compassionate		VB
compel	compel		VB
compensate	compensate		VB
compere	compere		VB
compete	compete		VB
compile	compile		VB
complain	complain		VB
complect	complect		VB
complement	complement		VB
complete	complete		VB
complexify	complexify		VB
complexion	complexion		VB
complicate	complicate		VB
compliment	compliment		VB
complot	complot		VB
comply	comply		VB
comport	comport		VB
compose	compose		VB
compost	compost		VB
compound	compound		VB
comprehend	comprehend		VB
compress	compress		VB
comprise	comprise		VB
compromise	compromise		VB
compute	compute		VB
computerise	computerise		VB
computerize	computerize		VB
concatenate	concatenate		VB
conceal	conceal		VB
concede	concede		VB
conceive	conceive		VB
concenter	concenter		VB
concentrate	concentrate		VB
concentre	concentre		VB
conceptualise	conceptualise		VB
conceptualize	conceptualize		VB
concern	concern		VB
concert	concert		VB
concertina	concertina		VB
concertise	concertise		VB
concertize	concertize		VB
conciliate	conciliate		VB
conclude	conclude		VB
concoct	concoct		VB
con	con		VB
concord	concord		VB
concrete	concrete		VB
concretise	concretise		VB
concretize	concretize		VB
concur	concur		VB
concuss	concuss		VB
condemn	condemn		VB
condense	condense		VB
condescend	condescend		VB
condition	condition		VB
condole	condole		VB
condone	condone		VB
conduce	conduce		VB
conduct	conduct		VB
cone	cone		VB
confab	confab		VB
confabulate	confabulate		VB
confect	confect		VB
confection	confection		VB
confederate	confederate		VB
confer	confer		VB
confess	confess		VB
confide	confide		VB
configure	configure		VB
confine	confine		VB
confirm	confirm		VB
confiscate	confiscate		VB
conflagrate	conflagrate		VB
conflate	conflate		VB
conflict	conflict		VB
conform	conform		VB
confound	confound		VB
confront	confront		VB
confuse	confuse		VB
confute	confute		VB
conga	conga		VB
congeal	congeal		VB
conge	conge		VB
congee	congee		VB
congest	congest		VB
conglobate	conglobate		VB
conglobe	conglobe		VB
conglomerate	conglomerate		VB
conglutinate	conglutinate		VB
congratulate	congratulate		VB
congregate	congregate		VB
conjecture	conjecture		VB
conjoin	conjoin		VB
conjugate	conjugate		VB
conjure	conjure		VB
conk	conk		VB
conn	conn		VB
connect	connect		VB
connive	connive		VB
connote	connote		VB
conquer	conquer		VB
conscript	conscript		VB
consecrate	consecrate		VB
consent	consent		VB
conserve	conserve		VB
consider	consider		VB
consign	consign		VB
consist	consist		VB
consociate	consociate		VB
console	console		VB
consolidate	consolidate		VB
consonate	consonate		VB
consort	consort		VB
conspire	conspire		VB
constellate	constellate		VB
consternate	consternate		VB
constipate	constipate		VB
constitute	constitute		VB
constitutionalise	constitutionalise		VB
constitutionalize	constitutionalize		VB
constrain	constrain		VB
constrict	constrict		VB
constringe	constringe		VB
construct	construct		VB
construe	construe		VB
consubstantiate	consubstantiate		VB
consult	consult		VB
consume	consume		VB
consummate	consummate		VB
contact	contact		VB
contain	contain		VB
containerise	containerise		VB
containerize	containerize		VB
contaminate	contaminate		VB
contemn	contemn		VB
contemplate	contemplate		VB
contemporise	contemporise		VB
contemporize	contemporize		VB
contend	contend		VB
content	content		VB
contest	contest		VB
continue	continue		VB
contort	contort		VB
contour	contour		VB
contract	contract		VB
contradance	contradance		VB
contradict	contradict		VB
contradistinguish	contradistinguish		VB
contraindicate	contraindicate		VB
contrast	contrast		VB
contravene	contravene		VB
contredanse	contredanse		VB
contribute	contribute		VB
contrive	contrive		VB
control	control		VB
controvert	controvert		VB
contuse	contuse		VB
convalesce	convalesce		VB
convect	convect		VB
convene	convene		VB
conventionalise	conventionalise		VB
conventionalize	conventionalize		VB
converge	converge		VB
converse	converse		VB
convert	convert		VB
convey	convey		VB
convict	convict		VB
convince	convince		VB
convoke	convoke		VB
convolute	convolute		VB
convolve	convolve		VB
convoy	convoy		VB
convulse	convulse		VB
co-occur	co-occur		VB
cooccur	cooccur		VB
coo	coo		VB
cook	cook		VB
cool	cool		VB
cooperate	cooperate		VB
cooper	cooper		VB
co-opt	co-opt		VB
coordinate	coordinate		VB
cop	cop		VB
cope	cope		VB
copolymerise	copolymerise		VB
copolymerize	copolymerize		VB
copper-bottom	copper-bottom		VB
copper	copper		VB
copulate	copulate		VB
copy	copy		VB
copyedit	copyedit		VB
copyread	copyread		VB
copyright	copyright		VB
coquet	coquet		VB
coquette	coquette		VB
corbel	corbel		VB
cord	cord		VB
corduroy	corduroy		VB
core	core		VB
cork	cork		VB
corkscrew	corkscrew		VB
corn	corn		VB
corner	corner		VB
cornice	cornice		VB
coronate	coronate		VB
corrade	corrade		VB
corral	corral		VB
correct	correct		VB
correlate	correlate		VB
correspond	correspond		VB
corroborate	corroborate		VB
corrode	corrode		VB
corrugate	corrugate		VB
corrupt	corrupt		VB
corset	corset		VB
coruscate	coruscate		VB
cosh	cosh		VB
co-sign	co-sign		VB
cosign	cosign		VB
cosponsor	cosponsor		VB
cosset	cosset		VB
co-star	co-star		VB
cost	cost		VB
costume	costume		VB
cotton	cotton		VB
couch	couch		VB
cough	cough		VB
counsel	counsel		VB
count	count		VB
countenance	countenance		VB
counteract	counteract		VB
counterattack	counterattack		VB
counterbalance	counterbalance		VB
counterchallenge	counterchallenge		VB
counterchange	counterchange		VB
countercheck	countercheck		VB
counterclaim	counterclaim		VB
counter	counter		VB
counter-drill	counter-drill		VB
counterfeit	counterfeit		VB
countermand	countermand		VB
countermarch	countermarch		VB
countermine	countermine		VB
counterplot	counterplot		VB
counterpoint	counterpoint		VB
counterpoise	counterpoise		VB
counterpose	counterpose		VB
countersign	countersign		VB
countersink	countersink		VB
counterstrike	counterstrike		VB
countervail	countervail		VB
counterweight	counterweight		VB
country-dance	country-dance		VB
couple	couple		VB
course	course		VB
court	court		VB
court-martial	court-martial		VB
co-vary	co-vary		VB
covenant	covenant		VB
cover	cover		VB
covet	covet		VB
cow	cow		VB
cower	cower		VB
cowhide	cowhide		VB
cowl	cowl		VB
cox	cox		VB
cozen	cozen		VB
crab	crab		VB
crack	crack		VB
crackle	crackle		VB
cradle	cradle		VB
craft	craft		VB
cram	cram		VB
cramp	cramp		VB
cranch	cranch		VB
crane	crane		VB
crank	crank		VB
crap	crap		VB
crape	crape		VB
crash	crash		VB
crash-dive	crash-dive		VB
crate	crate		VB
craunch	craunch		VB
crave	crave		VB
crawfish	crawfish		VB
crawl	crawl		VB
crayon	crayon		VB
craze	craze		VB
creak	creak		VB
cream	cream		VB
crease	crease		VB
create	create		VB
credit	credit		VB
creep	creep		VB
cremate	cremate		VB
crenelate	crenelate		VB
crenel	crenel		VB
crenellate	crenellate		VB
creolize	creolize		VB
creosote	creosote		VB
crepe	crepe		VB
crepitate	crepitate		VB
crescendo	crescendo		VB
crest	crest		VB
crew	crew		VB
crib	crib		VB
crick	crick		VB
cricket	cricket		VB
criminalise	criminalise		VB
criminalize	criminalize		VB
criminate	criminate		VB
crimp	crimp		VB
crimson	crimson		VB
cringe	cringe		VB
crinkle	crinkle		VB
cripple	cripple		VB
crisp	crisp		VB
crispen	crispen		VB
crisscross	crisscross		VB
criticise	criticise		VB
criticize	criticize		VB
critique	critique		VB
croak	croak		VB
crochet	crochet		VB
crock	crock		VB
cronk	cronk		VB
crook	crook		VB
croon	croon		VB
crop	crop		VB
croquet	croquet		VB
crossbreed	crossbreed		VB
cross-check	cross-check		VB
cross	cross		VB
crosscut	crosscut		VB
cross-dress	cross-dress		VB
cross-fertilise	cross-fertilise		VB
cross-fertilize	cross-fertilize		VB
cross-file	cross-file		VB
crosshatch	crosshatch		VB
cross-index	cross-index		VB
cross-link	cross-link		VB
cross-pollinate	cross-pollinate		VB
cross-refer	cross-refer		VB
crossruff	crossruff		VB
crouch	crouch		VB
crow	crow		VB
crowd	crowd		VB
crown	crown		VB
crucify	crucify		VB
cruise	cruise		VB
crumb	crumb		VB
crumble	crumble		VB
crump	crump		VB
crumple	crumple		VB
crunch	crunch		VB
crusade	crusade		VB
crush	crush		VB
crust	crust		VB
cry	cry		VB
crystalise	crystalise		VB
crystalize	crystalize		VB
crystallise	crystallise		VB
crystallize	crystallize		VB
cub	cub		VB
cube	cube		VB
cuckold	cuckold		VB
cuckoo	cuckoo		VB
cuddle	cuddle		VB
cudgel	cudgel		VB
cue	cue		VB
cuff	cuff		VB
cull	cull		VB
culminate	culminate		VB
cultivate	cultivate		VB
culture	culture		VB
cumber	cumber		VB
cumulate	cumulate		VB
cup	cup		VB
curb	curb		VB
curdle	curdle		VB
cure	cure		VB
curl	curl		VB
currycomb	currycomb		VB
curry	curry		VB
curse	curse		VB
curtail	curtail		VB
curtain	curtain		VB
curtsey	curtsey		VB
curtsy	curtsy		VB
curve	curve		VB
curvet	curvet		VB
cushion	cushion		VB
cuss	cuss		VB
customise	customise		VB
customize	customize		VB
custom-make	custom-make		VB
cut	cut		VB
cutinize	cutinize		VB
cybernate	cybernate		VB
cycle	cycle		VB
cyclostyle	cyclostyle		VB
cypher	cypher		VB
dabble	dabble		VB
dab	dab		VB
dado	dado		VB
daisy-chain	daisy-chain		VB
dally	dally		VB
damage	damage		VB
damascene	damascene		VB
dam	dam		VB
damn	damn		VB
damp	damp		VB
dampen	dampen		VB
dance	dance		VB
dandify	dandify		VB
dandle	dandle		VB
dangle	dangle		VB
dapple	dapple		VB
dare	dare		VB
darken	darken		VB
darn	darn		VB
dart	dart		VB
dash	dash		VB
date	date		VB
dateline	dateline		VB
date-mark	date-mark		VB
datemark	datemark		VB
daub	daub		VB
daunt	daunt		VB
dawdle	dawdle		VB
dawn	dawn		VB
daydream	daydream		VB
daze	daze		VB
dazzle	dazzle		VB
de-access	de-access		VB
deaccession	deaccession		VB
deactivate	deactivate		VB
deaden	deaden		VB
de-aerate	de-aerate		VB
deaerate	deaerate		VB
deaf	deaf		VB
deafen	deafen		VB
deal	deal		VB
deaminate	deaminate		VB
deaminize	deaminize		VB
debar	debar		VB
debark	debark		VB
debase	debase		VB
debate	debate		VB
debauch	debauch		VB
debilitate	debilitate		VB
debit	debit		VB
debone	debone		VB
debouch	debouch		VB
debrief	debrief		VB
debug	debug		VB
debunk	debunk		VB
debut	debut		VB
decaffeinate	decaffeinate		VB
decalcify	decalcify		VB
decamp	decamp		VB
decant	decant		VB
decapitate	decapitate		VB
decarbonate	decarbonate		VB
decarbonise	decarbonise		VB
decarbonize	decarbonize		VB
decarboxylate	decarboxylate		VB
decarburise	decarburise		VB
decarburize	decarburize		VB
decay	decay		VB
decease	decease		VB
deceive	deceive		VB
decelerate	decelerate		VB
decentralise	decentralise		VB
decentralize	decentralize		VB
decerebrate	decerebrate		VB
decertify	decertify		VB
dechlorinate	dechlorinate		VB
decide	decide		VB
decimalise	decimalise		VB
decimalize	decimalize		VB
decimate	decimate		VB
decipher	decipher		VB
deck	deck		VB
declaim	declaim		VB
declare	declare		VB
declassify	declassify		VB
declaw	declaw		VB
decline	decline		VB
declutch	declutch		VB
decoct	decoct		VB
decode	decode		VB
decoke	decoke		VB
decollate	decollate		VB
decolonise	decolonise		VB
decolonize	decolonize		VB
decolor	decolor		VB
decolorise	decolorise		VB
decolorize	decolorize		VB
decolour	decolour		VB
decolourise	decolourise		VB
decolourize	decolourize		VB
decommission	decommission		VB
decompose	decompose		VB
decompress	decompress		VB
deconcentrate	deconcentrate		VB
deconsecrate	deconsecrate		VB
deconstruct	deconstruct		VB
decontaminate	decontaminate		VB
decontrol	decontrol		VB
decorate	decorate		VB
decorticate	decorticate		VB
decouple	decouple		VB
decoy	decoy		VB
decrease	decrease		VB
decree	decree		VB
decrepitate	decrepitate		VB
decrescendo	decrescendo		VB
decriminalise	decriminalise		VB
decriminalize	decriminalize		VB
decry	decry		VB
decrypt	decrypt		VB
decussate	decussate		VB
dedicate	dedicate		VB
dedifferentiate	dedifferentiate		VB
deduce	deduce		VB
deduct	deduct		VB
deem	deem		VB
de-emphasise	de-emphasise		VB
de-emphasize	de-emphasize		VB
de-energise	de-energise		VB
de-energize	de-energize		VB
deep-dye	deep-dye		VB
deepen	deepen		VB
deep-fat-fry	deep-fat-fry		VB
deep-fry	deep-fry		VB
deep-six	deep-six		VB
de-escalate	de-escalate		VB
deface	deface		VB
defalcate	defalcate		VB
defame	defame		VB
defang	defang		VB
defat	defat		VB
default	default		VB
defeat	defeat		VB
defecate	defecate		VB
defect	defect		VB
defeminise	defeminise		VB
defeminize	defeminize		VB
defend	defend		VB
defenestrate	defenestrate		VB
defer	defer		VB
defervesce	defervesce		VB
defibrillate	defibrillate		VB
defibrinate	defibrinate		VB
defile	defile		VB
define	define		VB
deflagrate	deflagrate		VB
deflate	deflate		VB
deflect	deflect		VB
deflower	deflower		VB
defog	defog		VB
defoliate	defoliate		VB
deforest	deforest		VB
deform	deform		VB
defraud	defraud		VB
defray	defray		VB
defrock	defrock		VB
defrost	defrost		VB
defuse	defuse		VB
defy	defy		VB
degas	degas		VB
degauss	degauss		VB
degenerate	degenerate		VB
deglaze	deglaze		VB
deglycerolise	deglycerolise		VB
deglycerolize	deglycerolize		VB
degrade	degrade		VB
degrease	degrease		VB
degust	degust		VB
dehisce	dehisce		VB
dehorn	dehorn		VB
dehumanise	dehumanise		VB
dehumanize	dehumanize		VB
dehumidify	dehumidify		VB
dehydrate	dehydrate		VB
dehydrogenate	dehydrogenate		VB
de-ice	de-ice		VB
deice	deice		VB
deify	deify		VB
deign	deign		VB
de-iodinate	de-iodinate		VB
de-ionate	de-ionate		VB
deionize	deionize		VB
deject	deject		VB
delay	delay		VB
delegate	delegate		VB
delete	delete		VB
deliberate	deliberate		VB
delight	delight		VB
delimitate	delimitate		VB
delimit	delimit		VB
delineate	delineate		VB
deliquesce	deliquesce		VB
delist	delist		VB
deliver	deliver		VB
delocalize	delocalize		VB
delouse	delouse		VB
delude	delude		VB
deluge	deluge		VB
delve	delve		VB
demagnetise	demagnetise		VB
demagnetize	demagnetize		VB
demand	demand		VB
demarcate	demarcate		VB
demasculinise	demasculinise		VB
demasculinize	demasculinize		VB
dematerialise	dematerialise		VB
dematerialize	dematerialize		VB
demean	demean		VB
demilitarise	demilitarise		VB
demilitarize	demilitarize		VB
demineralise	demineralise		VB
demineralize	demineralize		VB
demise	demise		VB
demist	demist		VB
demob	demob		VB
demobilise	demobilise		VB
demobilize	demobilize		VB
democratise	democratise		VB
democratize	democratize		VB
demo	demo		VB
demodulate	demodulate		VB
demolish	demolish		VB
demonetise	demonetise		VB
demonetize	demonetize		VB
demonise	demonise		VB
demonize	demonize		VB
demonstrate	demonstrate		VB
demoralise	demoralise		VB
demoralize	demoralize		VB
demote	demote		VB
demulsify	demulsify		VB
demur	demur		VB
demyelinate	demyelinate		VB
demystify	demystify		VB
demythologise	demythologise		VB
demythologize	demythologize		VB
denationalise	denationalise		VB
denationalize	denationalize		VB
denaturalise	denaturalise		VB
denaturalize	denaturalize		VB
denature	denature		VB
denazify	denazify		VB
denigrate	denigrate		VB
denitrify	denitrify		VB
denominate	denominate		VB
denote	denote		VB
denounce	denounce		VB
dent	dent		VB
denudate	denudate		VB
denude	denude		VB
deny	deny		VB
deodorise	deodorise		VB
deodorize	deodorize		VB
deodourise	deodourise		VB
deoxidise	deoxidise		VB
deoxidize	deoxidize		VB
deoxygenate	deoxygenate		VB
depart	depart		VB
depend	depend		VB
depersonalise	depersonalise		VB
depersonalize	depersonalize		VB
depict	depict		VB
depilate	depilate		VB
deplane	deplane		VB
deplete	deplete		VB
deplore	deplore		VB
deploy	deploy		VB
deplumate	deplumate		VB
deplume	deplume		VB
depolarise	depolarise		VB
depolarize	depolarize		VB
depone	depone		VB
depopulate	depopulate		VB
deport	deport		VB
depose	depose		VB
deposit	deposit		VB
deprave	deprave		VB
deprecate	deprecate		VB
depreciate	depreciate		VB
depress	depress		VB
depressurise	depressurise		VB
depressurize	depressurize		VB
deprive	deprive		VB
depute	depute		VB
deputise	deputise		VB
deputize	deputize		VB
deracinate	deracinate		VB
derail	derail		VB
derange	derange		VB
derate	derate		VB
derecognise	derecognise		VB
derecognize	derecognize		VB
deregulate	deregulate		VB
derequisition	derequisition		VB
derestrict	derestrict		VB
deride	deride		VB
derive	derive		VB
derogate	derogate		VB
desacralize	desacralize		VB
desalinate	desalinate		VB
desalinise	desalinise		VB
desalinize	desalinize		VB
desalt	desalt		VB
descale	descale		VB
descant	descant		VB
descend	descend		VB
describe	describe		VB
descry	descry		VB
desecrate	desecrate		VB
desegregate	desegregate		VB
desensitise	desensitise		VB
desensitize	desensitize		VB
desert	desert		VB
deserve	deserve		VB
desex	desex		VB
desexualise	desexualise		VB
desexualize	desexualize		VB
desiccate	desiccate		VB
designate	designate		VB
design	design		VB
desire	desire		VB
desist	desist		VB
desolate	desolate		VB
desorb	desorb		VB
despair	despair		VB
despatch	despatch		VB
despise	despise		VB
despoil	despoil		VB
despond	despond		VB
desquamate	desquamate		VB
destabilise	destabilise		VB
destabilize	destabilize		VB
destain	destain		VB
destalinise	destalinise		VB
destalinize	destalinize		VB
destine	destine		VB
destress	destress		VB
destroy	destroy		VB
destruct	destruct		VB
desulfurize	desulfurize		VB
desulphurize	desulphurize		VB
desynchronise	desynchronise		VB
desynchronize	desynchronize		VB
detach	detach		VB
detail	detail		VB
detain	detain		VB
detect	detect		VB
deter	deter		VB
deterge	deterge		VB
deteriorate	deteriorate		VB
determine	determine		VB
detest	detest		VB
dethaw	dethaw		VB
dethrone	dethrone		VB
detick	detick		VB
detonate	detonate		VB
detour	detour		VB
detox	detox		VB
detoxicate	detoxicate		VB
detoxify	detoxify		VB
detract	detract		VB
detrain	detrain		VB
detransitivise	detransitivise		VB
detransitivize	detransitivize		VB
detribalise	detribalise		VB
detribalize	detribalize		VB
detusk	detusk		VB
devaluate	devaluate		VB
devalue	devalue		VB
devastate	devastate		VB
devein	devein		VB
develop	develop		VB
deviate	deviate		VB
devil	devil		VB
devilise	devilise		VB
devilize	devilize		VB
devise	devise		VB
devitalise	devitalise		VB
devitalize	devitalize		VB
devitrify	devitrify		VB
devoice	devoice		VB
devolve	devolve		VB
devote	devote		VB
devour	devour		VB
diabolise	diabolise		VB
diabolize	diabolize		VB
diagnose	diagnose		VB
diagonalise	diagonalise		VB
diagonalize	diagonalize		VB
diagram	diagram		VB
dial	dial		VB
dialyse	dialyse		VB
dialyze	dialyze		VB
diazotize	diazotize		VB
dibble	dibble		VB
dice	dice		VB
dichotomise	dichotomise		VB
dichotomize	dichotomize		VB
dicker	dicker		VB
dictate	dictate		VB
didder	didder		VB
diddle	diddle		VB
die	die		VB
diet	diet		VB
differ	differ		VB
differentiate	differentiate		VB
diffract	diffract		VB
diffuse	diffuse		VB
dig	dig		VB
digest	digest		VB
digitalise	digitalise		VB
digitalize	digitalize		VB
digitise	digitise		VB
digitize	digitize		VB
dignify	dignify		VB
digress	digress		VB
dike	dike		VB
dilapidate	dilapidate		VB
dilate	dilate		VB
dilly-dally	dilly-dally		VB
dillydally	dillydally		VB
dilute	dilute		VB
dim	dim		VB
dimension	dimension		VB
diminish	diminish		VB
dimple	dimple		VB
din	din		VB
dine	dine		VB
ding	ding		VB
dingdong	dingdong		VB
dinge	dinge		VB
dip	dip		VB
diphthongise	diphthongise		VB
diphthongize	diphthongize		VB
direct	direct		VB
dirty	dirty		VB
disable	disable		VB
disabuse	disabuse		VB
disaccord	disaccord		VB
disadvantage	disadvantage		VB
disaffect	disaffect		VB
disafforest	disafforest		VB
disagree	disagree		VB
disallow	disallow		VB
disambiguate	disambiguate		VB
disappear	disappear		VB
disappoint	disappoint		VB
disapprove	disapprove		VB
disarm	disarm		VB
disarrange	disarrange		VB
disarray	disarray		VB
disarticulate	disarticulate		VB
disassemble	disassemble		VB
disassociate	disassociate		VB
disavow	disavow		VB
disband	disband		VB
disbar	disbar		VB
disbelieve	disbelieve		VB
disbud	disbud		VB
disburden	disburden		VB
disburse	disburse		VB
discard	discard		VB
discase	discase		VB
discern	discern		VB
discerp	discerp		VB
discharge	discharge		VB
discipline	discipline		VB
disc-jockey	disc-jockey		VB
disclaim	disclaim		VB
disclose	disclose		VB
disco	disco		VB
discolor	discolor		VB
discolorise	discolorise		VB
discolorize	discolorize		VB
discolour	discolour		VB
discolourise	discolourise		VB
discombobulate	discombobulate		VB
discomfit	discomfit		VB
discommode	discommode		VB
discompose	discompose		VB
disconcert	disconcert		VB
disconnect	disconnect		VB
discontent	discontent		VB
discontinue	discontinue		VB
discord	discord		VB
discount	discount		VB
discountenance	discountenance		VB
discourage	discourage		VB
discourse	discourse		VB
discover	discover		VB
discredit	discredit		VB
discriminate	discriminate		VB
discuss	discuss		VB
disdain	disdain		VB
disembark	disembark		VB
disembarrass	disembarrass		VB
disembody	disembody		VB
disembowel	disembowel		VB
disembroil	disembroil		VB
disenable	disenable		VB
disenchant	disenchant		VB
disencumber	disencumber		VB
disenfranchise	disenfranchise		VB
disengage	disengage		VB
disentangle	disentangle		VB
disestablish	disestablish		VB
disesteem	disesteem		VB
disfavor	disfavor		VB
disfavour	disfavour		VB
disfigure	disfigure		VB
disforest	disforest		VB
disfranchise	disfranchise		VB
disgorge	disgorge		VB
disgrace	disgrace		VB
disgruntle	disgruntle		VB
disguise	disguise		VB
disgust	disgust		VB
disharmonize	disharmonize		VB
dish	dish		VB
dishearten	dishearten		VB
dishevel	dishevel		VB
dishonor	dishonor		VB
dishonour	dishonour		VB
disillusion	disillusion		VB
disincarnate	disincarnate		VB
disincline	disincline		VB
disinfect	disinfect		VB
disinfest	disinfest		VB
disinherit	disinherit		VB
disintegrate	disintegrate		VB
disinter	disinter		VB
disinvest	disinvest		VB
disinvolve	disinvolve		VB
disjoin	disjoin		VB
disjoint	disjoint		VB
disk	disk		VB
disk-jockey	disk-jockey		VB
dislike	dislike		VB
dislocate	dislocate		VB
dislodge	dislodge		VB
dismantle	dismantle		VB
dismay	dismay		VB
dismember	dismember		VB
dismiss	dismiss		VB
dismount	dismount		VB
disobey	disobey		VB
disoblige	disoblige		VB
disorder	disorder		VB
disorganise	disorganise		VB
disorganize	disorganize		VB
disorientate	disorientate		VB
disorient	disorient		VB
disown	disown		VB
disparage	disparage		VB
dispatch	dispatch		VB
dispel	dispel		VB
dispense	dispense		VB
disperse	disperse		VB
dispirit	dispirit		VB
displace	displace		VB
display	display		VB
displease	displease		VB
displume	displume		VB
disport	disport		VB
dispose	dispose		VB
dispossess	dispossess		VB
dispread	dispread		VB
disprove	disprove		VB
dispute	dispute		VB
disqualify	disqualify		VB
disquiet	disquiet		VB
disregard	disregard		VB
disrespect	disrespect		VB
disrobe	disrobe		VB
disrupt	disrupt		VB
dissatisfy	dissatisfy		VB
diss	diss		VB
dissect	dissect		VB
dissemble	dissemble		VB
disseminate	disseminate		VB
dissent	dissent		VB
dissertate	dissertate		VB
dissever	dissever		VB
dissimilate	dissimilate		VB
dissimulate	dissimulate		VB
dissipate	dissipate		VB
dissociate	dissociate		VB
dissolve	dissolve		VB
dissonate	dissonate		VB
dissuade	dissuade		VB
distance	distance		VB
distemper	distemper		VB
distend	distend		VB
distil	distil		VB
distill	distill		VB
distinguish	distinguish		VB
distort	distort		VB
distract	distract		VB
distrain	distrain		VB
distress	distress		VB
distribute	distribute		VB
district	district		VB
distrust	distrust		VB
disturb	disturb		VB
disunify	disunify		VB
disunite	disunite		VB
ditch	ditch		VB
dither	dither		VB
ditto	ditto		VB
divagate	divagate		VB
divaricate	divaricate		VB
dive-bomb	dive-bomb		VB
dive	dive		VB
diverge	diverge		VB
diversify	diversify		VB
divert	divert		VB
divest	divest		VB
divide	divide		VB
divine	divine		VB
divorce	divorce		VB
divulge	divulge		VB
dizen	dizen		VB
dizzy	dizzy		VB
DJ	DJ		VB
dock	dock		VB
docket	docket		VB
doctor	doctor		VB
document	document		VB
dodder	dodder		VB
dodge	dodge		VB
do	do		VB
doff	doff		VB
dog	dog		VB
dogfight	dogfight		VB
dogmatise	dogmatise		VB
dogmatize	dogmatize		VB
dogsled	dogsled		VB
domesticate	domesticate		VB
domesticise	domesticise		VB
domesticize	domesticize		VB
domicile	domicile		VB
domiciliate	domiciliate		VB
dominate	dominate		VB
domineer	domineer		VB
donate	donate		VB
don	don		VB
dong	dong		VB
doodle	doodle		VB
doom	doom		VB
dope	dope		VB
dose	dose		VB
doss	doss		VB
dot	dot		VB
dote	dote		VB
double-check	double-check		VB
double-date	double-date		VB
double	double		VB
double-glaze	double-glaze		VB
double-park	double-park		VB
double-space	double-space		VB
double-team	double-team		VB
doubt	doubt		VB
douche	douche		VB
douse	douse		VB
dovetail	dovetail		VB
dower	dower		VB
down	down		VB
downgrade	downgrade		VB
download	download		VB
downplay	downplay		VB
downsize	downsize		VB
dowse	dowse		VB
doze	doze		VB
draft	draft		VB
drag	drag		VB
draggle	draggle		VB
dragoon	dragoon		VB
drain	drain		VB
dramatise	dramatise		VB
dramatize	dramatize		VB
drape	drape		VB
draught	draught		VB
draw	draw		VB
drawl	drawl		VB
dread	dread		VB
dream	dream		VB
dredge	dredge		VB
drench	drench		VB
dress	dress		VB
dribble	dribble		VB
drift	drift		VB
drill	drill		VB
drink	drink		VB
drip	drip		VB
drip-dry	drip-dry		VB
drive	drive		VB
drivel	drivel		VB
drizzle	drizzle		VB
drone	drone		VB
drool	drool		VB
droop	droop		VB
drop	drop		VB
dropforge	dropforge		VB
drop-kick	drop-kick		VB
dropkick	dropkick		VB
drown	drown		VB
drowse	drowse		VB
drub	drub		VB
drudge	drudge		VB
drug	drug		VB
drum	drum		VB
dry-dock	dry-dock		VB
drydock	drydock		VB
dry	dry		VB
dry-nurse	dry-nurse		VB
dry-rot	dry-rot		VB
dry-wall	dry-wall		VB
dub	dub		VB
duck	duck		VB
duel	duel		VB
dulcify	dulcify		VB
dulcorate	dulcorate		VB
dull	dull		VB
dumbfound	dumbfound		VB
dummy	dummy		VB
dump	dump		VB
dun	dun		VB
dung	dung		VB
dunk	dunk		VB
dupe	dupe		VB
duplex	duplex		VB
duplicate	duplicate		VB
dusk	dusk		VB
dust	dust		VB
dwarf	dwarf		VB
dwell	dwell		VB
dwindle	dwindle		VB
dye	dye		VB
dyke	dyke		VB
dynamise	dynamise		VB
dynamite	dynamite		VB
dynamize	dynamize		VB
eagle	eagle		VB
earmark	earmark		VB
earn	earn		VB
earth	earth		VB
ease	ease		VB
eat	eat		VB
eavesdrop	eavesdrop		VB
ebb	ebb		VB
ebonise	ebonise		VB
ebonize	ebonize		VB
echo	echo		VB
eclipse	eclipse		VB
economise	economise		VB
economize	economize		VB
eddy	eddy		VB
edge	edge		VB
edify	edify		VB
edit	edit		VB
editorialise	editorialise		VB
editorialize	editorialize		VB
educate	educate		VB
educe	educe		VB
edulcorate	edulcorate		VB
efface	efface		VB
effect	effect		VB
effectuate	effectuate		VB
eff	eff		VB
effeminise	effeminise		VB
effeminize	effeminize		VB
effervesce	effervesce		VB
effloresce	effloresce		VB
effuse	effuse		VB
egest	egest		VB
egg	egg		VB
egotrip	egotrip		VB
egress	egress		VB
ejaculate	ejaculate		VB
eject	eject		VB
elaborate	elaborate		VB
elapse	elapse		VB
elate	elate		VB
elbow	elbow		VB
elect	elect		VB
electioneer	electioneer		VB
electrify	electrify		VB
electrocute	electrocute		VB
electroplate	electroplate		VB
elegise	elegise		VB
elegize	elegize		VB
elevate	elevate		VB
elicit	elicit		VB
elide	elide		VB
eliminate	eliminate		VB
elocute	elocute		VB
elongate	elongate		VB
elope	elope		VB
elucidate	elucidate		VB
elude	elude		VB
elute	elute		VB
emaciate	emaciate		VB
e-mail	e-mail		VB
email	email		VB
emanate	emanate		VB
emancipate	emancipate		VB
emasculate	emasculate		VB
embalm	embalm		VB
embank	embank		VB
embargo	embargo		VB
embark	embark		VB
embarrass	embarrass		VB
embattle	embattle		VB
embed	embed		VB
embellish	embellish		VB
embezzle	embezzle		VB
embitter	embitter		VB
emblazon	emblazon		VB
embody	embody		VB
embolden	embolden		VB
emboss	emboss		VB
embower	embower		VB
embrace	embrace		VB
embrangle	embrangle		VB
embrittle	embrittle		VB
embrocate	embrocate		VB
embroider	embroider		VB
embroil	embroil		VB
embrown	embrown		VB
emcee	emcee		VB
emend	emend		VB
emerge	emerge		VB
emigrate	emigrate		VB
emit	emit		VB
emote	emote		VB
empale	empale		VB
empanel	empanel		VB
empathise	empathise		VB
empathize	empathize		VB
emphasise	emphasise		VB
emphasize	emphasize		VB
emplace	emplace		VB
emplane	emplane		VB
employ	employ		VB
empower	empower		VB
empty	empty		VB
empurple	empurple		VB
emulate	emulate		VB
emulsify	emulsify		VB
enable	enable		VB
enact	enact		VB
enamel	enamel		VB
enamor	enamor		VB
enamour	enamour		VB
encamp	encamp		VB
encapsulate	encapsulate		VB
encase	encase		VB
enchain	enchain		VB
enchant	enchant		VB
encipher	encipher		VB
encircle	encircle		VB
enclose	enclose		VB
enclothe	enclothe		VB
encode	encode		VB
encompass	encompass		VB
encore	encore		VB
encounter	encounter		VB
encourage	encourage		VB
encrimson	encrimson		VB
encroach	encroach		VB
encrust	encrust		VB
encrypt	encrypt		VB
encumber	encumber		VB
endanger	endanger		VB
endear	endear		VB
endeavor	endeavor		VB
endeavour	endeavour		VB
end	end		VB
endorse	endorse		VB
endow	endow		VB
endue	endue		VB
endure	endure		VB
energise	energise		VB
energize	energize		VB
enervate	enervate		VB
enfeeble	enfeeble		VB
enfeoff	enfeoff		VB
enfilade	enfilade		VB
enfold	enfold		VB
enforce	enforce		VB
enfranchise	enfranchise		VB
engage	engage		VB
engender	engender		VB
engild	engild		VB
engineer	engineer		VB
englut	englut		VB
engorge	engorge		VB
engraft	engraft		VB
engrave	engrave		VB
engross	engross		VB
engulf	engulf		VB
enhance	enhance		VB
enjoin	enjoin		VB
enjoy	enjoy		VB
enkindle	enkindle		VB
enlace	enlace		VB
enlarge	enlarge		VB
enlighten	enlighten		VB
enlist	enlist		VB
enliven	enliven		VB
enmesh	enmesh		VB
ennoble	ennoble		VB
enounce	enounce		VB
enplane	enplane		VB
enquire	enquire		VB
enrage	enrage		VB
enrapture	enrapture		VB
enrich	enrich		VB
enrobe	enrobe		VB
enrol	enrol		VB
enroll	enroll		VB
ensconce	ensconce		VB
enshrine	enshrine		VB
enshroud	enshroud		VB
ensile	ensile		VB
ensky	ensky		VB
enslave	enslave		VB
ensnare	ensnare		VB
ensnarl	ensnarl		VB
ensue	ensue		VB
ensure	ensure		VB
entail	entail		VB
entangle	entangle		VB
enter	enter		VB
entertain	entertain		VB
enthral	enthral		VB
enthrall	enthrall		VB
enthrone	enthrone		VB
enthuse	enthuse		VB
entice	entice		VB
entitle	entitle		VB
entomb	entomb		VB
entrain	entrain		VB
entrance	entrance		VB
entrap	entrap		VB
entreat	entreat		VB
entrench	entrench		VB
entrust	entrust		VB
entwine	entwine		VB
enucleate	enucleate		VB
enumerate	enumerate		VB
enunciate	enunciate		VB
envelop	envelop		VB
envenom	envenom		VB
environ	environ		VB
envisage	envisage		VB
envision	envision		VB
envy	envy		VB
enwrap	enwrap		VB
epilate	epilate		VB
epitomise	epitomise		VB
epitomize	epitomize		VB
epoxy	epoxy		VB
equal	equal		VB
equalise	equalise		VB
equalize	equalize		VB
equate	equate		VB
equilibrate	equilibrate		VB
equilibrise	equilibrise		VB
equilibrize	equilibrize		VB
equip	equip		VB
equivocate	equivocate		VB
eradicate	eradicate		VB
erase	erase		VB
erect	erect		VB
erode	erode		VB
eroticize	eroticize		VB
err	err		VB
eruct	eruct		VB
erupt	erupt		VB
escalade	escalade		VB
escalate	escalate		VB
escallop	escallop		VB
escape	escape		VB
eschew	eschew		VB
escort	escort		VB
espouse	espouse		VB
espy	espy		VB
essay	essay		VB
establish	establish		VB
esteem	esteem		VB
esterify	esterify		VB
estimate	estimate		VB
estivate	estivate		VB
estrange	estrange		VB
etch	etch		VB
eternalise	eternalise		VB
eternalize	eternalize		VB
eternise	eternise		VB
eternize	eternize		VB
etherealize	etherealize		VB
etherialise	etherialise		VB
etherify	etherify		VB
etherise	etherise		VB
etherize	etherize		VB
etiolate	etiolate		VB
etymologise	etymologise		VB
etymologize	etymologize		VB
eulogise	eulogise		VB
eulogize	eulogize		VB
euphemise	euphemise		VB
euphemize	euphemize		VB
Europeanise	Europeanise		VB
Europeanize	Europeanize		VB
evacuate	evacuate		VB
evade	evade		VB
evaluate	evaluate		VB
evanesce	evanesce		VB
evangelise	evangelise		VB
evangelize	evangelize		VB
evaporate	evaporate		VB
even	even		VB
eventuate	eventuate		VB
evert	evert		VB
evict	evict		VB
evidence	evidence		VB
evince	evince		VB
eviscerate	eviscerate		VB
evoke	evoke		VB
evolve	evolve		VB
exacerbate	exacerbate		VB
exact	exact		VB
exaggerate	exaggerate		VB
exalt	exalt		VB
examine	examine		VB
exasperate	exasperate		VB
excavate	excavate		VB
exceed	exceed		VB
excel	excel		VB
except	except		VB
excerpt	excerpt		VB
exchange	exchange		VB
excise	excise		VB
excite	excite		VB
exclaim	exclaim		VB
exclude	exclude		VB
excogitate	excogitate		VB
excommunicate	excommunicate		VB
excoriate	excoriate		VB
excrete	excrete		VB
excruciate	excruciate		VB
exculpate	exculpate		VB
excuse	excuse		VB
execrate	execrate		VB
execute	execute		VB
exemplify	exemplify		VB
exempt	exempt		VB
exenterate	exenterate		VB
exercise	exercise		VB
exert	exert		VB
exfoliate	exfoliate		VB
exhale	exhale		VB
exhaust	exhaust		VB
exhibit	exhibit		VB
exhilarate	exhilarate		VB
exhort	exhort		VB
exhume	exhume		VB
exile	exile		VB
exist	exist		VB
exit	exit		VB
exonerate	exonerate		VB
exorcise	exorcise		VB
exorcize	exorcize		VB
expand	expand		VB
expatiate	expatiate		VB
expatriate	expatriate		VB
expect	expect		VB
expectorate	expectorate		VB
expedite	expedite		VB
expel	expel		VB
expend	expend		VB
expense	expense		VB
experience	experience		VB
experiment	experiment		VB
expiate	expiate		VB
expire	expire		VB
explain	explain		VB
explicate	explicate		VB
explode	explode		VB
exploit	exploit		VB
explore	explore		VB
export	export		VB
expose	expose		VB
exposit	exposit		VB
expostulate	expostulate		VB
expound	expound		VB
express	express		VB
express-mail	express-mail		VB
expropriate	expropriate		VB
expunge	expunge		VB
expurgate	expurgate		VB
exsert	exsert		VB
exsiccate	exsiccate		VB
extemporise	extemporise		VB
extemporize	extemporize		VB
extend	extend		VB
extenuate	extenuate		VB
exteriorise	exteriorise		VB
exteriorize	exteriorize		VB
exterminate	exterminate		VB
externalise	externalise		VB
externalize	externalize		VB
extinguish	extinguish		VB
extirpate	extirpate		VB
extol	extol		VB
extort	extort		VB
extract	extract		VB
extradite	extradite		VB
extrapolate	extrapolate		VB
extravasate	extravasate		VB
extricate	extricate		VB
extrude	extrude		VB
exuberate	exuberate		VB
exudate	exudate		VB
exude	exude		VB
exult	exult		VB
exuviate	exuviate		VB
eyeball	eyeball		VB
eye	eye		VB
eyewitness	eyewitness		VB
fabricate	fabricate		VB
face	face		VB
face-harden	face-harden		VB
face-lift	face-lift		VB
facilitate	facilitate		VB
facsimile	facsimile		VB
factor	factor		VB
factorise	factorise		VB
factorize	factorize		VB
fade	fade		VB
fag	fag		VB
faggot	faggot		VB
fagot	fagot		VB
fail	fail		VB
faint	faint		VB
fair	fair		VB
fake	fake		VB
falcon	falcon		VB
fall	fall		VB
falsify	falsify		VB
falter	falter		VB
familiarise	familiarise		VB
familiarize	familiarize		VB
famish	famish		VB
fancify	fancify		VB
fancy	fancy		VB
fan	fan		VB
fantasise	fantasise		VB
fantasize	fantasize		VB
fantasy	fantasy		VB
farce	farce		VB
fare	fare		VB
farm	farm		VB
farrow	farrow		VB
fart	fart		VB
fascinate	fascinate		VB
fashion	fashion		VB
fasten	fasten		VB
fast	fast		VB
fate	fate		VB
fat	fat		VB
father	father		VB
fathom	fathom		VB
fatigue	fatigue		VB
fatten	fatten		VB
fault	fault		VB
favor	favor		VB
favour	favour		VB
fawn	fawn		VB
fax	fax		VB
faze	faze		VB
fear	fear		VB
feast	feast		VB
featherbed	featherbed		VB
feather	feather		VB
feature	feature		VB
fecundate	fecundate		VB
federalise	federalise		VB
federalize	federalize		VB
federate	federate		VB
feed	feed		VB
fee	fee		VB
feel	feel		VB
fee-tail	fee-tail		VB
feign	feign		VB
feint	feint		VB
felicitate	felicitate		VB
fellate	fellate		VB
fell	fell		VB
felt	felt		VB
feminise	feminise		VB
feminize	feminize		VB
fence	fence		VB
fend	fend		VB
ferment	ferment		VB
ferret	ferret		VB
ferry	ferry		VB
fertilise	fertilise		VB
fertilize	fertilize		VB
fester	fester		VB
festinate	festinate		VB
festoon	festoon		VB
fetch	fetch		VB
fete	fete		VB
fetishize	fetishize		VB
fetter	fetter		VB
fettle	fettle		VB
feudalize	feudalize		VB
feud	feud		VB
fib	fib		VB
fibrillate	fibrillate		VB
fictionalise	fictionalise		VB
fictionalize	fictionalize		VB
fiddle	fiddle		VB
fidget	fidget		VB
field	field		VB
field-test	field-test		VB
fight	fight		VB
figure	figure		VB
filch	filch		VB
file	file		VB
filet	filet		VB
filiate	filiate		VB
filibuster	filibuster		VB
filigree	filigree		VB
fillet	fillet		VB
fill	fill		VB
film	film		VB
film-make	film-make		VB
filter	filter		VB
filtrate	filtrate		VB
finagle	finagle		VB
finalise	finalise		VB
finalize	finalize		VB
finance	finance		VB
financier	financier		VB
find	find		VB
finedraw	finedraw		VB
fine	fine		VB
fine-tune	fine-tune		VB
fin	fin		VB
finger	finger		VB
finger-paint	finger-paint		VB
fingerprint	fingerprint		VB
finger-spell	finger-spell		VB
fingerspell	fingerspell		VB
finish	finish		VB
fink	fink		VB
firebomb	firebomb		VB
fire	fire		VB
fireproof	fireproof		VB
firm	firm		VB
fish	fish		VB
fishtail	fishtail		VB
fissure	fissure		VB
fistfight	fistfight		VB
fit	fit		VB
fixate	fixate		VB
fix	fix		VB
fizz	fizz		VB
fizzle	fizzle		VB
flabbergast	flabbergast		VB
flagellate	flagellate		VB
flag	flag		VB
flail	flail		VB
flake	flake		VB
flambe	flambe		VB
flame	flame		VB
flank	flank		VB
flap	flap		VB
flare	flare		VB
flash	flash		VB
flash-freeze	flash-freeze		VB
flat-hat	flat-hat		VB
flatten	flatten		VB
flatter	flatter		VB
flaunt	flaunt		VB
flavor	flavor		VB
flavour	flavour		VB
flaw	flaw		VB
flay	flay		VB
fleck	fleck		VB
fledge	fledge		VB
fleece	fleece		VB
flee	flee		VB
fleer	fleer		VB
fleet	fleet		VB
flense	flense		VB
flesh	flesh		VB
flex	flex		VB
flicker	flicker		VB
flick	flick		VB
flight	flight		VB
flim-flam	flim-flam		VB
flinch	flinch		VB
fling	fling		VB
flip	flip		VB
flip-flop	flip-flop		VB
flirt	flirt		VB
flit	flit		VB
flitter	flitter		VB
float	float		VB
flocculate	flocculate		VB
flock	flock		VB
flog	flog		VB
flood	flood		VB
floodlight	floodlight		VB
floor	floor		VB
flop	flop		VB
floss	floss		VB
flounce	flounce		VB
flounder	flounder		VB
flour	flour		VB
flourish	flourish		VB
flout	flout		VB
flower	flower		VB
flow	flow		VB
flub	flub		VB
fluctuate	fluctuate		VB
fluff	fluff		VB
flummox	flummox		VB
flump	flump		VB
flunk	flunk		VB
fluoresce	fluoresce		VB
fluoridate	fluoridate		VB
fluoridise	fluoridise		VB
fluoridize	fluoridize		VB
flurry	flurry		VB
flush	flush		VB
fluster	fluster		VB
flute	flute		VB
flutter	flutter		VB
flux	flux		VB
fly-fish	fly-fish		VB
flyfish	flyfish		VB
fly	fly		VB
foal	foal		VB
foam	foam		VB
fob	fob		VB
focalise	focalise		VB
focalize	focalize		VB
focus	focus		VB
fodder	fodder		VB
fog	fog		VB
foil	foil		VB
foist	foist		VB
fold	fold		VB
foliate	foliate		VB
follow	follow		VB
foment	foment		VB
fondle	fondle		VB
fool	fool		VB
foolproof	foolproof		VB
foot	foot		VB
footle	footle		VB
footnote	footnote		VB
footslog	footslog		VB
forage	forage		VB
foray	foray		VB
forbear	forbear		VB
forbid	forbid		VB
force-feed	force-feed		VB
force	force		VB
force-land	force-land		VB
ford	ford		VB
forearm	forearm		VB
forebode	forebode		VB
forecast	forecast		VB
foreclose	foreclose		VB
foredate	foredate		VB
foredoom	foredoom		VB
forefend	forefend		VB
foregather	foregather		VB
forego	forego		VB
foreground	foreground		VB
foreknow	foreknow		VB
foreordain	foreordain		VB
foresee	foresee		VB
foreshadow	foreshadow		VB
foreshorten	foreshorten		VB
foreshow	foreshow		VB
forestall	forestall		VB
forest	forest		VB
foreswear	foreswear		VB
foretell	foretell		VB
forewarn	forewarn		VB
forfeit	forfeit		VB
forfend	forfend		VB
forgather	forgather		VB
forge	forge		VB
forget	forget		VB
forgive	forgive		VB
forgo	forgo		VB
fork	fork		VB
formalise	formalise		VB
formalize	formalize		VB
format	format		VB
form	form		VB
formicate	formicate		VB
formularise	formularise		VB
formularize	formularize		VB
formulate	formulate		VB
fornicate	fornicate		VB
forsake	forsake		VB
forswear	forswear		VB
fort	fort		VB
fortify	fortify		VB
forward	forward		VB
fossilise	fossilise		VB
fossilize	fossilize		VB
foster	foster		VB
foul	foul		VB
founder	founder		VB
found	found		VB
fowl	fowl		VB
fox	fox		VB
foxhunt	foxhunt		VB
foxtrot	foxtrot		VB
fractionate	fractionate		VB
fraction	fraction		VB
fracture	fracture		VB
fragment	fragment		VB
fragmentise	fragmentise		VB
fragmentize	fragmentize		VB
frame	frame		VB
franchise	franchise		VB
frank	frank		VB
frap	frap		VB
fraternise	fraternise		VB
fraternize	fraternize		VB
fray	fray		VB
frazzle	frazzle		VB
freak	freak		VB
freckle	freckle		VB
free-associate	free-associate		VB
free-base	free-base		VB
free	free		VB
freelance	freelance		VB
freeload	freeload		VB
freewheel	freewheel		VB
freeze-dry	freeze-dry		VB
freeze	freeze		VB
freight	freight		VB
French	French		VB
french-fry	french-fry		VB
Frenchify	Frenchify		VB
frequent	frequent		VB
fresco	fresco		VB
freshen	freshen		VB
fress	fress		VB
fret	fret		VB
fricassee	fricassee		VB
frighten	frighten		VB
fright	fright		VB
fringe	fringe		VB
frisk	frisk		VB
fritter	fritter		VB
frivol	frivol		VB
frizz	frizz		VB
frizzle	frizzle		VB
frock	frock		VB
frog	frog		VB
frogmarch	frogmarch		VB
frolic	frolic		VB
front	front		VB
frost	frost		VB
froth	froth		VB
frown	frown		VB
fructify	fructify		VB
fruit	fruit		VB
frustrate	frustrate		VB
fry	fry		VB
FTP	FTP		VB
fuck	fuck		VB
fuddle	fuddle		VB
fudge	fudge		VB
fuel	fuel		VB
fulfil	fulfil		VB
fulfill	fulfill		VB
fullback	fullback		VB
full	full		VB
fulminate	fulminate		VB
fumble	fumble		VB
fume	fume		VB
fumigate	fumigate		VB
function	function		VB
fund	fund		VB
fund-raise	fund-raise		VB
fundraise	fundraise		VB
funk	funk		VB
funnel	funnel		VB
furbish	furbish		VB
furcate	furcate		VB
furl	furl		VB
furlough	furlough		VB
furnish	furnish		VB
furrow	furrow		VB
further	further		VB
fuse	fuse		VB
fusillade	fusillade		VB
fuss	fuss		VB
fustigate	fustigate		VB
gabble	gabble		VB
gab	gab		VB
gad	gad		VB
gage	gage		VB
gag	gag		VB
gaggle	gaggle		VB
gain	gain		VB
gainsay	gainsay		VB
gall	gall		VB
gallivant	gallivant		VB
gallop	gallop		VB
galumph	galumph		VB
galvanise	galvanise		VB
galvanize	galvanize		VB
gamble	gamble		VB
gambol	gambol		VB
game	game		VB
gang	gang		VB
gang-rape	gang-rape		VB
gangrene	gangrene		VB
gaol	gaol		VB
gape	gape		VB
gap	gap		VB
garage	garage		VB
garb	garb		VB
garble	garble		VB
garden	garden		VB
gargle	gargle		VB
garland	garland		VB
garment	garment		VB
garner	garner		VB
garnishee	garnishee		VB
garnish	garnish		VB
garotte	garotte		VB
garrison	garrison		VB
garrote	garrote		VB
garrotte	garrotte		VB
garter	garter		VB
gasconade	gasconade		VB
gas	gas		VB
gash	gash		VB
gasify	gasify		VB
gasp	gasp		VB
gate-crash	gate-crash		VB
gate	gate		VB
gather	gather		VB
gauffer	gauffer		VB
gauge	gauge		VB
gawk	gawk		VB
gawp	gawp		VB
gaze	gaze		VB
gazette	gazette		VB
gazump	gazump		VB
gear	gear		VB
gee	gee		VB
gelatinise	gelatinise		VB
gelatinize	gelatinize		VB
geld	geld		VB
gel	gel		VB
geminate	geminate		VB
general	general		VB
generalise	generalise		VB
generalize	generalize		VB
generate	generate		VB
gentle	gentle		VB
gentrify	gentrify		VB
genuflect	genuflect		VB
germinate	germinate		VB
gerrymander	gerrymander		VB
gestate	gestate		VB
gesticulate	gesticulate		VB
gesture	gesture		VB
get	get		VB
geyser	geyser		VB
ghettoise	ghettoise		VB
ghettoize	ghettoize		VB
ghost	ghost		VB
ghostwrite	ghostwrite		VB
gibber	gibber		VB
gibbet	gibbet		VB
gibe	gibe		VB
gift	gift		VB
gift-wrap	gift-wrap		VB
giggle	giggle		VB
G.I.	G.I.		VB
GI	GI		VB
gild	gild		VB
gimp	gimp		VB
ginger	ginger		VB
gin	gin		VB
gip	gip		VB
gird	gird		VB
girdle	girdle		VB
girth	girth		VB
give	give		VB
glaciate	glaciate		VB
gladden	gladden		VB
glamorise	glamorise		VB
glamorize	glamorize		VB
glamour	glamour		VB
glamourise	glamourise		VB
glamourize	glamourize		VB
glance	glance		VB
glare	glare		VB
glass	glass		VB
glaze	glaze		VB
gleam	gleam		VB
glean	glean		VB
glide-bomb	glide-bomb		VB
glide	glide		VB
glimmer	glimmer		VB
glimpse	glimpse		VB
glint	glint		VB
glissade	glissade		VB
glisten	glisten		VB
glitter	glitter		VB
gloat	gloat		VB
globalise	globalise		VB
globalize	globalize		VB
globe-trot	globe-trot		VB
glom	glom		VB
glorify	glorify		VB
glory	glory		VB
gloss	gloss		VB
glower	glower		VB
glow	glow		VB
glue	glue		VB
glug	glug		VB
glut	glut		VB
gluttonise	gluttonise		VB
gluttonize	gluttonize		VB
glycerolise	glycerolise		VB
glycerolize	glycerolize		VB
gnarl	gnarl		VB
gnash	gnash		VB
gnaw	gnaw		VB
goad	goad		VB
gobble	gobble		VB
goffer	goffer		VB
goggle	goggle		VB
go	go		VB
goldbrick	goldbrick		VB
gold-plate	gold-plate		VB
goldplate	goldplate		VB
golf	golf		VB
gong	gong		VB
goof	goof		VB
goof-proof	goof-proof		VB
goofproof	goofproof		VB
google	google		VB
goose	goose		VB
gore	gore		VB
gorge	gorge		VB
gormandise	gormandise		VB
gormandize	gormandize		VB
gossip	gossip		VB
gouge	gouge		VB
gourmandize	gourmandize		VB
govern	govern		VB
gown	gown		VB
grab	grab		VB
grace	grace		VB
gradate	gradate		VB
grade	grade		VB
graduate	graduate		VB
graft	graft		VB
grain	grain		VB
grandstand	grandstand		VB
grant	grant		VB
granulate	granulate		VB
graph	graph		VB
grapple	grapple		VB
grasp	grasp		VB
grass	grass		VB
grate	grate		VB
gratify	gratify		VB
grave	grave		VB
gravel	gravel		VB
gravitate	gravitate		VB
gray	gray		VB
graze	graze		VB
grease	grease		VB
green	green		VB
greet	greet		VB
grey	grey		VB
griddle	griddle		VB
grieve	grieve		VB
grill	grill		VB
grimace	grimace		VB
grime	grime		VB
grind	grind		VB
grin	grin		VB
gripe	gripe		VB
grip	grip		VB
grit	grit		VB
grizzle	grizzle		VB
groak	groak		VB
groan	groan		VB
groin	groin		VB
grok	grok		VB
groom	groom		VB
groove	groove		VB
grope	grope		VB
gross	gross		VB
grouch	grouch		VB
ground	ground		VB
group	group		VB
grouse	grouse		VB
grout	grout		VB
grovel	grovel		VB
grow	grow		VB
growl	growl		VB
grub	grub		VB
grubstake	grubstake		VB
grudge	grudge		VB
grumble	grumble		VB
grunt	grunt		VB
grunt-hoot	grunt-hoot		VB
gruntle	gruntle		VB
guarantee	guarantee		VB
guard	guard		VB
guess	guess		VB
guesstimate	guesstimate		VB
guffaw	guffaw		VB
guggle	guggle		VB
guide	guide		VB
guillotine	guillotine		VB
gull	gull		VB
gulp	gulp		VB
gum	gum		VB
gun	gun		VB
gurgle	gurgle		VB
gush	gush		VB
gut	gut		VB
gutter	gutter		VB
guttle	guttle		VB
guy	guy		VB
guzzle	guzzle		VB
gybe	gybe		VB
gyp	gyp		VB
gyrate	gyrate		VB
habilitate	habilitate		VB
habit	habit		VB
habituate	habituate		VB
hack	hack		VB
hackle	hackle		VB
haemagglutinate	haemagglutinate		VB
haggle	haggle		VB
hail	hail		VB
hale	hale		VB
halloo	halloo		VB
hallow	hallow		VB
hallucinate	hallucinate		VB
halter	halter		VB
halt	halt		VB
halve	halve		VB
ham	ham		VB
hammer	hammer		VB
hamper	hamper		VB
hamstring	hamstring		VB
hand-build	hand-build		VB
handbuild	handbuild		VB
handcolor	handcolor		VB
handcolour	handcolour		VB
handcraft	handcraft		VB
handcuff	handcuff		VB
hand-dye	hand-dye		VB
hand	hand		VB
handicap	handicap		VB
handle	handle		VB
hand-pick	hand-pick		VB
handstamp	handstamp		VB
hand-wash	hand-wash		VB
handwash	handwash		VB
handwrite	handwrite		VB
hang	hang		VB
hanker	hanker		VB
hap	hap		VB
happen	happen		VB
harangue	harangue		VB
harass	harass		VB
harbinger	harbinger		VB
harbor	harbor		VB
harbour	harbour		VB
harden	harden		VB
hare	hare		VB
harken	harken		VB
hark	hark		VB
harlequin	harlequin		VB
harm	harm		VB
harmonise	harmonise		VB
harmonize	harmonize		VB
harness	harness		VB
harp	harp		VB
harpoon	harpoon		VB
harrow	harrow		VB
harry	harry		VB
harshen	harshen		VB
harvest	harvest		VB
hash	hash		VB
hasp	hasp		VB
hassle	hassle		VB
hasten	hasten		VB
hatchel	hatchel		VB
hatch	hatch		VB
hate	hate		VB
hat	hat		VB
haul	haul		VB
haunt	haunt		VB
have	have		VB
haw	haw		VB
hawk	hawk		VB
hay	hay		VB
hazard	hazard		VB
haze	haze		VB
headbutt	headbutt		VB
head	head		VB
headline	headline		VB
headquarter	headquarter		VB
heal	heal		VB
heap	heap		VB
hear	hear		VB
hearken	hearken		VB
hearten	hearten		VB
heat	heat		VB
heave	heave		VB
heckle	heckle		VB
hectograph	hectograph		VB
hector	hector		VB
hedge	hedge		VB
hedgehop	hedgehop		VB
heed	heed		VB
hee-haw	hee-haw		VB
heel	heel		VB
heft	heft		VB
heighten	heighten		VB
heist	heist		VB
heliograph	heliograph		VB
helm	helm		VB
help	help		VB
hemagglutinate	hemagglutinate		VB
hem	hem		VB
hemorrhage	hemorrhage		VB
hemstitch	hemstitch		VB
henna	henna		VB
hen-peck	hen-peck		VB
herald	herald		VB
herd	herd		VB
hero-worship	hero-worship		VB
hesitate	hesitate		VB
heterodyne	heterodyne		VB
hew	hew		VB
hex	hex		VB
hibachi	hibachi		VB
hibernate	hibernate		VB
hiccough	hiccough		VB
hiccup	hiccup		VB
hide	hide		VB
hie	hie		VB
higgle	higgle		VB
highjack	highjack		VB
highlight	highlight		VB
high-tail	high-tail		VB
hightail	hightail		VB
hijack	hijack		VB
hike	hike		VB
hill	hill		VB
hinder	hinder		VB
hinge	hinge		VB
hint	hint		VB
hire	hire		VB
hiss	hiss		VB
hitchhike	hitchhike		VB
hitch	hitch		VB
hit	hit		VB
hive	hive		VB
hoard	hoard		VB
hoax	hoax		VB
hobble	hobble		VB
hob	hob		VB
hobnail	hobnail		VB
hobnob	hobnob		VB
hock	hock		VB
hoe	hoe		VB
hog	hog		VB
hog-tie	hog-tie		VB
hoist	hoist		VB
hold	hold		VB
hole	hole		VB
holiday	holiday		VB
holler	holler		VB
hollo	hollo		VB
hollow	hollow		VB
holystone	holystone		VB
home	home		VB
homer	homer		VB
home-school	home-school		VB
homestead	homestead		VB
homogenise	homogenise		VB
homogenize	homogenize		VB
homologise	homologise		VB
homologize	homologize		VB
hone	hone		VB
honeycomb	honeycomb		VB
honey	honey		VB
honeymoon	honeymoon		VB
honk	honk		VB
honor	honor		VB
honour	honour		VB
hood	hood		VB
hoodoo	hoodoo		VB
hoodwink	hoodwink		VB
hoof	hoof		VB
hook	hook		VB
hoop	hoop		VB
hoot	hoot		VB
hoover	hoover		VB
hope	hope		VB
hop	hop		VB
hopple	hopple		VB
hop-skip	hop-skip		VB
horn	horn		VB
hornswoggle	hornswoggle		VB
horrify	horrify		VB
horripilate	horripilate		VB
horse	horse		VB
horse-race	horse-race		VB
horseshoe	horseshoe		VB
horse-trade	horse-trade		VB
horsewhip	horsewhip		VB
hose	hose		VB
hospitalise	hospitalise		VB
hospitalize	hospitalize		VB
host	host		VB
hot-dog	hot-dog		VB
hotfoot	hotfoot		VB
hot-wire	hot-wire		VB
hot-work	hot-work		VB
hound	hound		VB
housebreak	housebreak		VB
houseclean	houseclean		VB
house	house		VB
housekeep	housekeep		VB
house-train	house-train		VB
hover	hover		VB
howl	howl		VB
huckster	huckster		VB
huddle	huddle		VB
hue	hue		VB
huff	huff		VB
hug	hug		VB
hulk	hulk		VB
hull	hull		VB
humanise	humanise		VB
humanize	humanize		VB
humble	humble		VB
humbug	humbug		VB
hum	hum		VB
humidify	humidify		VB
humify	humify		VB
humiliate	humiliate		VB
humor	humor		VB
humour	humour		VB
hump	hump		VB
hunch	hunch		VB
hunger	hunger		VB
hunker	hunker		VB
hunt	hunt		VB
hurdle	hurdle		VB
hurl	hurl		VB
hurrah	hurrah		VB
hurry	hurry		VB
hurt	hurt		VB
hurtle	hurtle		VB
husband	husband		VB
hush	hush		VB
husk	husk		VB
hustle	hustle		VB
hybridise	hybridise		VB
hybridize	hybridize		VB
hydrate	hydrate		VB
hydrogenate	hydrogenate		VB
hydrogen-bomb	hydrogen-bomb		VB
hydrolise	hydrolise		VB
hydrolize	hydrolize		VB
hydrolyse	hydrolyse		VB
hydrolyze	hydrolyze		VB
hydroplane	hydroplane		VB
hygienise	hygienise		VB
hygienize	hygienize		VB
hymn	hymn		VB
hype	hype		VB
hyperbolise	hyperbolise		VB
hyperbolize	hyperbolize		VB
hyperextend	hyperextend		VB
hypertrophy	hypertrophy		VB
hyperventilate	hyperventilate		VB
hyphenate	hyphenate		VB
hyphen	hyphen		VB
hypnotise	hypnotise		VB
hypnotize	hypnotize		VB
hypophysectomise	hypophysectomise		VB
hypophysectomize	hypophysectomize		VB
hypostatise	hypostatise		VB
hypostatize	hypostatize		VB
hypothecate	hypothecate		VB
hypothesise	hypothesise		VB
hypothesize	hypothesize		VB
ice	ice		VB
idealise	idealise		VB
idealize	idealize		VB
ideate	ideate		VB
identify	identify		VB
idle	idle		VB
idolise	idolise		VB
idolize	idolize		VB
ignite	ignite		VB
ignore	ignore		VB
illegalise	illegalise		VB
illegalize	illegalize		VB
ill-treat	ill-treat		VB
illume	illume		VB
illuminate	illuminate		VB
illumine	illumine		VB
ill-use	ill-use		VB
illustrate	illustrate		VB
image	image		VB
imagine	imagine		VB
imbed	imbed		VB
imbibe	imbibe		VB
imbricate	imbricate		VB
imbrue	imbrue		VB
imbue	imbue		VB
imitate	imitate		VB
immaterialise	immaterialise		VB
immaterialize	immaterialize		VB
immerse	immerse		VB
immigrate	immigrate		VB
immingle	immingle		VB
immix	immix		VB
immobilise	immobilise		VB
immobilize	immobilize		VB
immolate	immolate		VB
immortalise	immortalise		VB
immortalize	immortalize		VB
immunise	immunise		VB
immunize	immunize		VB
immure	immure		VB
impact	impact		VB
impair	impair		VB
impale	impale		VB
impanel	impanel		VB
impart	impart		VB
impeach	impeach		VB
impede	impede		VB
impel	impel		VB
impend	impend		VB
imperil	imperil		VB
impersonate	impersonate		VB
impinge	impinge		VB
implant	implant		VB
implement	implement		VB
implicate	implicate		VB
implode	implode		VB
implore	implore		VB
imply	imply		VB
import	import		VB
importune	importune		VB
impose	impose		VB
impound	impound		VB
impoverish	impoverish		VB
imprecate	imprecate		VB
impregnate	impregnate		VB
impress	impress		VB
imprint	imprint		VB
imprison	imprison		VB
improve	improve		VB
improvise	improvise		VB
improvize	improvize		VB
impugn	impugn		VB
impulse-buy	impulse-buy		VB
impute	impute		VB
inactivate	inactivate		VB
inaugurate	inaugurate		VB
incandesce	incandesce		VB
incapacitate	incapacitate		VB
incarcerate	incarcerate		VB
incarnadine	incarnadine		VB
incarnate	incarnate		VB
incase	incase		VB
incense	incense		VB
inch	inch		VB
incinerate	incinerate		VB
incise	incise		VB
incite	incite		VB
incline	incline		VB
inclose	inclose		VB
include	include		VB
incommode	incommode		VB
inconvenience	inconvenience		VB
incorporate	incorporate		VB
increase	increase		VB
incriminate	incriminate		VB
incrust	incrust		VB
incubate	incubate		VB
inculcate	inculcate		VB
inculpate	inculpate		VB
incur	incur		VB
incurvate	incurvate		VB
indemnify	indemnify		VB
indent	indent		VB
indenture	indenture		VB
index	index		VB
indicate	indicate		VB
indict	indict		VB
indispose	indispose		VB
indite	indite		VB
individualise	individualise		VB
individualize	individualize		VB
individuate	individuate		VB
indoctrinate	indoctrinate		VB
indorse	indorse		VB
induce	induce		VB
induct	induct		VB
indue	indue		VB
indulge	indulge		VB
indurate	indurate		VB
industrialise	industrialise		VB
industrialize	industrialize		VB
indwell	indwell		VB
inebriate	inebriate		VB
infatuate	infatuate		VB
infect	infect		VB
infer	infer		VB
infest	infest		VB
infiltrate	infiltrate		VB
infix	infix		VB
inflame	inflame		VB
inflate	inflate		VB
inflect	inflect		VB
inflict	inflict		VB
influence	influence		VB
inform	inform		VB
infract	infract		VB
infringe	infringe		VB
infuriate	infuriate		VB
infuscate	infuscate		VB
infuse	infuse		VB
ingeminate	ingeminate		VB
ingest	ingest		VB
ingraft	ingraft		VB
ingrain	ingrain		VB
ingratiate	ingratiate		VB
ingurgitate	ingurgitate		VB
inhabit	inhabit		VB
inhale	inhale		VB
inhere	inhere		VB
inherit	inherit		VB
inhibit	inhibit		VB
inhume	inhume		VB
initial	initial		VB
initialise	initialise		VB
initialize	initialize		VB
initiate	initiate		VB
inject	inject		VB
injure	injure		VB
ink	ink		VB
inlay	inlay		VB
inmarry	inmarry		VB
innervate	innervate		VB
innovate	innovate		VB
inoculate	inoculate		VB
inosculate	inosculate		VB
input	input		VB
inquire	inquire		VB
inscribe	inscribe		VB
inseminate	inseminate		VB
insert	insert		VB
inset	inset		VB
insinuate	insinuate		VB
insist	insist		VB
insolate	insolate		VB
inspan	inspan		VB
inspect	inspect		VB
inspire	inspire		VB
inspirit	inspirit		VB
inspissate	inspissate		VB
instal	instal		VB
install	install		VB
instance	instance		VB
instantiate	instantiate		VB
instigate	instigate		VB
instil	instil		VB
instill	instill		VB
institute	institute		VB
institutionalise	institutionalise		VB
institutionalize	institutionalize		VB
instruct	instruct		VB
instrumentate	instrumentate		VB
instrument	instrument		VB
insufflate	insufflate		VB
insulate	insulate		VB
insult	insult		VB
insure	insure		VB
integrate	integrate		VB
intend	intend		VB
intensify	intensify		VB
interact	interact		VB
interbreed	interbreed		VB
intercalate	intercalate		VB
intercede	intercede		VB
intercept	intercept		VB
interchange	interchange		VB
intercommunicate	intercommunicate		VB
interconnect	interconnect		VB
interdepend	interdepend		VB
interdict	interdict		VB
interest	interest		VB
interfere	interfere		VB
inter	inter		VB
interiorise	interiorise		VB
interiorize	interiorize		VB
interject	interject		VB
interlace	interlace		VB
interlard	interlard		VB
interleave	interleave		VB
interlink	interlink		VB
interlock	interlock		VB
interlope	interlope		VB
interlude	interlude		VB
intermarry	intermarry		VB
intermediate	intermediate		VB
intermingle	intermingle		VB
intermit	intermit		VB
intermix	intermix		VB
internalise	internalise		VB
internalize	internalize		VB
internationalise	internationalise		VB
internationalize	internationalize		VB
intern	intern		VB
interpellate	interpellate		VB
interpenetrate	interpenetrate		VB
interpolate	interpolate		VB
interpose	interpose		VB
interpret	interpret		VB
interrelate	interrelate		VB
interrogate	interrogate		VB
interrupt	interrupt		VB
intersect	intersect		VB
intersperse	intersperse		VB
interstratify	interstratify		VB
intertwine	intertwine		VB
intervene	intervene		VB
interview	interview		VB
interweave	interweave		VB
intimate	intimate		VB
intimidate	intimidate		VB
intonate	intonate		VB
intone	intone		VB
intoxicate	intoxicate		VB
intransitivise	intransitivise		VB
intransitivize	intransitivize		VB
intrench	intrench		VB
intrigue	intrigue		VB
introduce	introduce		VB
introject	introject		VB
intromit	intromit		VB
introspect	introspect		VB
introvert	introvert		VB
intrude	intrude		VB
intrust	intrust		VB
intubate	intubate		VB
intuit	intuit		VB
intumesce	intumesce		VB
intussuscept	intussuscept		VB
inunct	inunct		VB
inundate	inundate		VB
inure	inure		VB
invade	invade		VB
invaginate	invaginate		VB
invalidate	invalidate		VB
invalid	invalid		VB
inveigh	inveigh		VB
inveigle	inveigle		VB
invent	invent		VB
inventory	inventory		VB
invert	invert		VB
investigate	investigate		VB
invest	invest		VB
invigilate	invigilate		VB
invigorate	invigorate		VB
invite	invite		VB
invoice	invoice		VB
invoke	invoke		VB
involve	involve		VB
inweave	inweave		VB
iodinate	iodinate		VB
iodise	iodise		VB
iodize	iodize		VB
ionate	ionate		VB
ionise	ionise		VB
ionize	ionize		VB
iridesce	iridesce		VB
irk	irk		VB
iron	iron		VB
irradiate	irradiate		VB
irrigate	irrigate		VB
irritate	irritate		VB
irrupt	irrupt		VB
Islamise	Islamise		VB
Islamize	Islamize		VB
isolate	isolate		VB
isomerise	isomerise		VB
isomerize	isomerize		VB
issue	issue		VB
italicise	italicise		VB
italicize	italicize		VB
itch	itch		VB
itemise	itemise		VB
itemize	itemize		VB
iterate	iterate		VB
itinerate	itinerate		VB
jabber	jabber		VB
jab	jab		VB
jacket	jacket		VB
jack	jack		VB
jackknife	jackknife		VB
jacklight	jacklight		VB
jackrabbit	jackrabbit		VB
jactitate	jactitate		VB
jade	jade		VB
jag	jag		VB
jail	jail		VB
jam	jam		VB
jampack	jampack		VB
jangle	jangle		VB
japan	japan		VB
jar	jar		VB
jaundice	jaundice		VB
jaunt	jaunt		VB
jawbone	jawbone		VB
jaw	jaw		VB
jaywalk	jaywalk		VB
jazz	jazz		VB
jeer	jeer		VB
jellify	jellify		VB
jell	jell		VB
jelly	jelly		VB
jeopardise	jeopardise		VB
jeopardize	jeopardize		VB
jerk	jerk		VB
jest	jest		VB
jet	jet		VB
jettison	jettison		VB
jewel	jewel		VB
jibe	jibe		VB
jib	jib		VB
jiggle	jiggle		VB
jig	jig		VB
jilt	jilt		VB
jimmy	jimmy		VB
jingle-jangle	jingle-jangle		VB
jingle	jingle		VB
jinx	jinx		VB
jitterbug	jitterbug		VB
jive	jive		VB
job	job		VB
jockey	jockey		VB
joggle	joggle		VB
jog	jog		VB
join	join		VB
joint	joint		VB
joke	joke		VB
jollify	jollify		VB
jolly	jolly		VB
jolt	jolt		VB
josh	josh		VB
jostle	jostle		VB
jot	jot		VB
jounce	jounce		VB
journey	journey		VB
joust	joust		VB
joy	joy		VB
joyride	joyride		VB
jubilate	jubilate		VB
judder	judder		VB
judge	judge		VB
juggle	juggle		VB
jug	jug		VB
julienne	julienne		VB
jumble	jumble		VB
jump	jump		VB
jump-start	jump-start		VB
jumpstart	jumpstart		VB
junketeer	junketeer		VB
junket	junket		VB
junk	junk		VB
justify	justify		VB
jut	jut		VB
juxtapose	juxtapose		VB
kayak	kayak		VB
kayo	kayo		VB
keel	keel		VB
keen	keen		VB
keep	keep		VB
kennel	kennel		VB
keratinise	keratinise		VB
keratinize	keratinize		VB
kern	kern		VB
key	key		VB
keynote	keynote		VB
kibbitz	kibbitz		VB
kibitz	kibitz		VB
kibosh	kibosh		VB
kick	kick		VB
kick-start	kick-start		VB
kid	kid		VB
kidnap	kidnap		VB
kill	kill		VB
kindle	kindle		VB
kink	kink		VB
kip	kip		VB
kiss	kiss		VB
kite	kite		VB
kit	kit		VB
kitten	kitten		VB
knap	knap		VB
knead	knead		VB
kneecap	kneecap		VB
kneel	kneel		VB
knell	knell		VB
knife	knife		VB
knight	knight		VB
knit	knit		VB
knock	knock		VB
knot	knot		VB
know	know		VB
knuckle	knuckle		VB
kotow	kotow		VB
kowtow	kowtow		VB
kvetch	kvetch		VB
label	label		VB
labialise	labialise		VB
labialize	labialize		VB
labor	labor		VB
labour	labour		VB
lace	lace		VB
lacerate	lacerate		VB
lack	lack		VB
lacquer	lacquer		VB
lactate	lactate		VB
ladder	ladder		VB
lade	lade		VB
laden	laden		VB
ladle	ladle		VB
lag	lag		VB
laicise	laicise		VB
laicize	laicize		VB
lallygag	lallygag		VB
lambaste	lambaste		VB
lambast	lambast		VB
lamb	lamb		VB
lame	lame		VB
lament	lament		VB
laminate	laminate		VB
lam	lam		VB
lampoon	lampoon		VB
lance	lance		VB
land	land		VB
landscape	landscape		VB
languish	languish		VB
lapidate	lapidate		VB
lapidify	lapidify		VB
lap	lap		VB
lapse	lapse		VB
lard	lard		VB
lark	lark		VB
larn	larn		VB
larrup	larrup		VB
lash	lash		VB
lasso	lasso		VB
last	last		VB
latch	latch		VB
lateralize	lateralize		VB
lather	lather		VB
latinise	latinise		VB
Latinise	Latinise		VB
latinize	latinize		VB
Latinize	Latinize		VB
laud	laud		VB
laugh	laugh		VB
launch	launch		VB
launder	launder		VB
lave	lave		VB
lavish	lavish		VB
layer	layer		VB
lay	lay		VB
laze	laze		VB
leach	leach		VB
lead	lead		VB
leaf	leaf		VB
league	league		VB
leak	leak		VB
lean	lean		VB
leapfrog	leapfrog		VB
leap	leap		VB
learn	learn		VB
lease	lease		VB
leash	leash		VB
leather	leather		VB
leave	leave		VB
leaven	leaven		VB
lecture	lecture		VB
leech	leech		VB
leer	leer		VB
legalise	legalise		VB
legalize	legalize		VB
legislate	legislate		VB
legitimate	legitimate		VB
legitimatise	legitimatise		VB
legitimatize	legitimatize		VB
legitimise	legitimise		VB
legitimize	legitimize		VB
lend	lend		VB
lengthen	lengthen		VB
lenify	lenify		VB
lessen	lessen		VB
let	let		VB
letter	letter		VB
levant	levant		VB
level	level		VB
leverage	leverage		VB
lever	lever		VB
levitate	levitate		VB
levy	levy		VB
lexicalise	lexicalise		VB
lexicalize	lexicalize		VB
liaise	liaise		VB
libel	libel		VB
liberalise	liberalise		VB
liberalize	liberalize		VB
liberate	liberate		VB
librate	librate		VB
licence	licence		VB
license	license		VB
lick	lick		VB
lie	lie		VB
lifehack	lifehack		VB
lift	lift		VB
ligate	ligate		VB
lighten	lighten		VB
lighter	lighter		VB
light	light		VB
lignify	lignify		VB
like	like		VB
liken	liken		VB
lilt	lilt		VB
limber	limber		VB
lime	lime		VB
limit	limit		VB
limn	limn		VB
limp	limp		VB
linearise	linearise		VB
linearize	linearize		VB
line	line		VB
linger	linger		VB
link	link		VB
lionise	lionise		VB
lionize	lionize		VB
lip-read	lip-read		VB
lipread	lipread		VB
lipstick	lipstick		VB
lip-synch	lip-synch		VB
lip-sync	lip-sync		VB
liquefy	liquefy		VB
liquidate	liquidate		VB
liquidise	liquidise		VB
liquidize	liquidize		VB
liquify	liquify		VB
lisp	lisp		VB
listen	listen		VB
list	list		VB
literalise	literalise		VB
literalize	literalize		VB
lithograph	lithograph		VB
litigate	litigate		VB
litter	litter		VB
live	live		VB
liven	liven		VB
load	load		VB
loaf	loaf		VB
loan	loan		VB
loathe	loathe		VB
lobby	lobby		VB
lob	lob		VB
localise	localise		VB
localize	localize		VB
locate	locate		VB
lock	lock		VB
locomote	locomote		VB
lodge	lodge		VB
loft	loft		VB
log-in	log-in		VB
log	log		VB
logroll	logroll		VB
loiter	loiter		VB
loll	loll		VB
lollop	lollop		VB
lollygag	lollygag		VB
long	long		VB
look	look		VB
loom	loom		VB
loop	loop		VB
loose	loose		VB
loosen	loosen		VB
loot	loot		VB
lope	lope		VB
lop	lop		VB
lord	lord		VB
lose	lose		VB
lot	lot		VB
louden	louden		VB
lounge	lounge		VB
lour	lour		VB
love	love		VB
lowball	lowball		VB
lower	lower		VB
low	low		VB
lube	lube		VB
lubricate	lubricate		VB
lucubrate	lucubrate		VB
luff	luff		VB
luge	luge		VB
lug	lug		VB
lull	lull		VB
lumber	lumber		VB
luminesce	luminesce		VB
lump	lump		VB
lunch	lunch		VB
lunge	lunge		VB
lurch	lurch		VB
lure	lure		VB
lurk	lurk		VB
lust	lust		VB
lustrate	lustrate		VB
luxate	luxate		VB
luxuriate	luxuriate		VB
lynch	lynch		VB
lyophilise	lyophilise		VB
lyophilize	lyophilize		VB
lyric	lyric		VB
lysogenize	lysogenize		VB
macadamise	macadamise		VB
macadamize	macadamize		VB
macerate	macerate		VB
machicolate	machicolate		VB
machinate	machinate		VB
machine	machine		VB
machine-wash	machine-wash		VB
macrame	macrame		VB
maculate	maculate		VB
madden	madden		VB
madder	madder		VB
madrigal	madrigal		VB
magnetise	magnetise		VB
magnetize	magnetize		VB
magnify	magnify		VB
mail	mail		VB
maim	maim		VB
mainline	mainline		VB
maintain	maintain		VB
major	major		VB
make	make		VB
maledict	maledict		VB
malfunction	malfunction		VB
malign	malign		VB
malinger	malinger		VB
malnourish	malnourish		VB
malt	malt		VB
maltreat	maltreat		VB
malversate	malversate		VB
mambo	mambo		VB
manacle	manacle		VB
manage	manage		VB
mandate	mandate		VB
manducate	manducate		VB
maneuver	maneuver		VB
mangle	mangle		VB
manhandle	manhandle		VB
manicure	manicure		VB
manifest	manifest		VB
manifold	manifold		VB
manipulate	manipulate		VB
man	man		VB
manoeuver	manoeuver		VB
manoeuvre	manoeuvre		VB
mantle	mantle		VB
manufacture	manufacture		VB
manumit	manumit		VB
manure	manure		VB
map	map		VB
mapquest	mapquest		VB
maraud	maraud		VB
marbleise	marbleise		VB
marbleize	marbleize		VB
marble	marble		VB
marcel	marcel		VB
march	march		VB
marginalise	marginalise		VB
marginalize	marginalize		VB
marinade	marinade		VB
marinate	marinate		VB
market	market		VB
mark	mark		VB
mar	mar		VB
maroon	maroon		VB
marry	marry		VB
marshal	marshal		VB
martyrise	martyrise		VB
martyrize	martyrize		VB
martyr	martyr		VB
marvel	marvel		VB
masculinise	masculinise		VB
masculinize	masculinize		VB
mash	mash		VB
mask	mask		VB
masquerade	masquerade		VB
massacre	massacre		VB
massage	massage		VB
mass	mass		VB
mass-produce	mass-produce		VB
master	master		VB
mastermind	mastermind		VB
masticate	masticate		VB
masturbate	masturbate		VB
match	match		VB
mate	mate		VB
materialise	materialise		VB
materialize	materialize		VB
mat	mat		VB
matriculate	matriculate		VB
matte	matte		VB
matter	matter		VB
matt-up	matt-up		VB
maturate	maturate		VB
mature	mature		VB
maul	maul		VB
maunder	maunder		VB
maximise	maximise		VB
maximize	maximize		VB
meander	meander		VB
mean	mean		VB
measure	measure		VB
mechanise	mechanise		VB
mechanize	mechanize		VB
meddle	meddle		VB
mediate	mediate		VB
medicate	medicate		VB
medicine	medicine		VB
meditate	meditate		VB
meet	meet		VB
melanise	melanise		VB
melanize	melanize		VB
meld	meld		VB
meliorate	meliorate		VB
mellow	mellow		VB
melodise	melodise		VB
melodize	melodize		VB
melt	melt		VB
memorialise	memorialise		VB
memorialize	memorialize		VB
memorise	memorise		VB
memorize	memorize		VB
menace	menace		VB
mend	mend		VB
menstruate	menstruate		VB
mensurate	mensurate		VB
mention	mention		VB
mentor	mentor		VB
meow	meow		VB
mercerise	mercerise		VB
mercerize	mercerize		VB
merchandise	merchandise		VB
merge	merge		VB
merit	merit		VB
mesh	mesh		VB
mesmerise	mesmerise		VB
mesmerize	mesmerize		VB
message	message		VB
mess	mess		VB
metabolise	metabolise		VB
metabolize	metabolize		VB
metalize	metalize		VB
metallize	metallize		VB
metal	metal		VB
metamorphose	metamorphose		VB
metastasise	metastasise		VB
metastasize	metastasize		VB
meter	meter		VB
metricate	metricate		VB
metricise	metricise		VB
metricize	metricize		VB
metrify	metrify		VB
mewl	mewl		VB
mew	mew		VB
miaou	miaou		VB
miaow	miaow		VB
micro-cook	micro-cook		VB
microcopy	microcopy		VB
microfilm	microfilm		VB
microwave	microwave		VB
micturate	micturate		VB
middle	middle		VB
miff	miff		VB
migrate	migrate		VB
mildew	mildew		VB
militarise	militarise		VB
militarize	militarize		VB
militate	militate		VB
milk	milk		VB
mill	mill		VB
mime	mime		VB
mimeograph	mimeograph		VB
mimeo	mimeo		VB
mimic	mimic		VB
mince	mince		VB
mind	mind		VB
mine	mine		VB
mineralize	mineralize		VB
mingle	mingle		VB
miniate	miniate		VB
miniaturise	miniaturise		VB
miniaturize	miniaturize		VB
minify	minify		VB
minimise	minimise		VB
minimize	minimize		VB
minister	minister		VB
minstrel	minstrel		VB
mint	mint		VB
mire	mire		VB
mirror	mirror		VB
misaddress	misaddress		VB
misadvise	misadvise		VB
misalign	misalign		VB
misally	misally		VB
misapply	misapply		VB
misapprehend	misapprehend		VB
misappropriate	misappropriate		VB
misbehave	misbehave		VB
misbelieve	misbelieve		VB
miscalculate	miscalculate		VB
miscall	miscall		VB
miscarry	miscarry		VB
miscast	miscast		VB
miscegenate	miscegenate		VB
misconceive	misconceive		VB
misconduct	misconduct		VB
misconstrue	misconstrue		VB
miscount	miscount		VB
miscreate	miscreate		VB
misdate	misdate		VB
misdeal	misdeal		VB
misdeliver	misdeliver		VB
misdemean	misdemean		VB
misdirect	misdirect		VB
misdo	misdo		VB
misestimate	misestimate		VB
misfire	misfire		VB
misfunction	misfunction		VB
misgauge	misgauge		VB
misgive	misgive		VB
misgovern	misgovern		VB
misguide	misguide		VB
mishandle	mishandle		VB
misidentify	misidentify		VB
misinform	misinform		VB
misinterpret	misinterpret		VB
misjudge	misjudge		VB
mislay	mislay		VB
mislead	mislead		VB
mismanage	mismanage		VB
mismarry	mismarry		VB
mismatch	mismatch		VB
mismate	mismate		VB
misname	misname		VB
misperceive	misperceive		VB
misplace	misplace		VB
misplay	misplay		VB
misprint	misprint		VB
mispronounce	mispronounce		VB
misquote	misquote		VB
misread	misread		VB
misremember	misremember		VB
misrepresent	misrepresent		VB
miss	miss		VB
misspeak	misspeak		VB
misspell	misspell		VB
misspend	misspend		VB
misstate	misstate		VB
mistake	mistake		VB
mistime	mistime		VB
mist	mist		VB
mistranslate	mistranslate		VB
mistreat	mistreat		VB
mistrust	mistrust		VB
misunderstand	misunderstand		VB
misuse	misuse		VB
miter	miter		VB
mitigate	mitigate		VB
mix	mix		VB
mizzle	mizzle		VB
moan	moan		VB
mobilise	mobilise		VB
mobilize	mobilize		VB
mob	mob		VB
mock	mock		VB
model	model		VB
moderate	moderate		VB
modernise	modernise		VB
modernize	modernize		VB
modify	modify		VB
modulate	modulate		VB
moil	moil		VB
moisten	moisten		VB
moisturise	moisturise		VB
moisturize	moisturize		VB
molder	molder		VB
mold	mold		VB
molest	molest		VB
mollify	mollify		VB
mollycoddle	mollycoddle		VB
molt	molt		VB
monetise	monetise		VB
monetize	monetize		VB
monger	monger		VB
mongrelise	mongrelise		VB
mongrelize	mongrelize		VB
monish	monish		VB
monitor	monitor		VB
monkey	monkey		VB
monologuise	monologuise		VB
monologuize	monologuize		VB
monopolise	monopolise		VB
monopolize	monopolize		VB
monumentalise	monumentalise		VB
monumentalize	monumentalize		VB
mooch	mooch		VB
moo	moo		VB
moonlight	moonlight		VB
moon	moon		VB
moonshine	moonshine		VB
moor	moor		VB
moot	moot		VB
mope	mope		VB
mop	mop		VB
moralise	moralise		VB
moralize	moralize		VB
morph	morph		VB
mortar	mortar		VB
mortgage	mortgage		VB
mortice	mortice		VB
mortify	mortify		VB
mortise	mortise		VB
mosey	mosey		VB
mosh	mosh		VB
mothball	mothball		VB
mother	mother		VB
mothproof	mothproof		VB
motion	motion		VB
motivate	motivate		VB
motley	motley		VB
motorbike	motorbike		VB
motorboat	motorboat		VB
motorcycle	motorcycle		VB
motorise	motorise		VB
motorize	motorize		VB
motor	motor		VB
mottle	mottle		VB
moulder	moulder		VB
mould	mould		VB
moult	moult		VB
mound	mound		VB
mountaineer	mountaineer		VB
mount	mount		VB
mourn	mourn		VB
mouse	mouse		VB
mousse	mousse		VB
mouth	mouth		VB
move	move		VB
mow	mow		VB
muck	muck		VB
muckrake	muckrake		VB
muddle	muddle		VB
muddy	muddy		VB
mud	mud		VB
mud-wrestle	mud-wrestle		VB
mudwrestle	mudwrestle		VB
muffle	muffle		VB
muff	muff		VB
mug	mug		VB
mulch	mulch		VB
mulct	mulct		VB
mull	mull		VB
multiply	multiply		VB
mumble	mumble		VB
mummify	mummify		VB
munch	munch		VB
munition	munition		VB
murder	murder		VB
murk	murk		VB
murmur	murmur		VB
muscle	muscle		VB
muse	muse		VB
mush	mush		VB
mushroom	mushroom		VB
mussitate	mussitate		VB
muss	muss		VB
muster	muster		VB
mutate	mutate		VB
mute	mute		VB
mutilate	mutilate		VB
mutiny	mutiny		VB
mutter	mutter		VB
muzzle	muzzle		VB
mystify	mystify		VB
mythicise	mythicise		VB
mythicize	mythicize		VB
mythologise	mythologise		VB
mythologize	mythologize		VB
nab	nab		VB
nag	nag		VB
nail	nail		VB
namedrop	namedrop		VB
name	name		VB
nap	nap		VB
narcotise	narcotise		VB
narcotize	narcotize		VB
nark	nark		VB
narrate	narrate		VB
narrow	narrow		VB
nasale	nasale		VB
nasalise	nasalise		VB
nasalize	nasalize		VB
nationalise	nationalise		VB
nationalize	nationalize		VB
natter	natter		VB
naturalise	naturalise		VB
naturalize	naturalize		VB
nauseate	nauseate		VB
navigate	navigate		VB
nazify	nazify		VB
near	near		VB
neaten	neaten		VB
necessitate	necessitate		VB
neck	neck		VB
necrose	necrose		VB
needle	needle		VB
need	need		VB
negate	negate		VB
negative	negative		VB
neglect	neglect		VB
negociate	negociate		VB
negotiate	negotiate		VB
neighbor	neighbor		VB
neighbour	neighbour		VB
neigh	neigh		VB
nerve	nerve		VB
nestle	nestle		VB
nest	nest		VB
netmail	netmail		VB
net	net		VB
nettle	nettle		VB
nett	nett		VB
network	network		VB
neuter	neuter		VB
neutralise	neutralise		VB
neutralize	neutralize		VB
nibble	nibble		VB
nickel-and-dime	nickel-and-dime		VB
nickel	nickel		VB
nicker	nicker		VB
nickname	nickname		VB
nick	nick		VB
nictate	nictate		VB
nictitate	nictitate		VB
niggle	niggle		VB
nigrify	nigrify		VB
nip	nip		VB
nitpick	nitpick		VB
nitrate	nitrate		VB
nitrify	nitrify		VB
nitrogenise	nitrogenise		VB
nitrogenize	nitrogenize		VB
nix	nix		VB
nobble	nobble		VB
nock	nock		VB
nod	nod		VB
noise	noise		VB
nol.pros.	nol.pros.		VB
nominate	nominate		VB
nonplus	nonplus		VB
noose	noose		VB
normalise	normalise		VB
normalize	normalize		VB
nosedive	nosedive		VB
nose	nose		VB
nosh	nosh		VB
notarise	notarise		VB
notarize	notarize		VB
notate	notate		VB
notch	notch		VB
note	note		VB
notice	notice		VB
notify	notify		VB
nourish	nourish		VB
novate	novate		VB
novelise	novelise		VB
novelize	novelize		VB
nucleate	nucleate		VB
nudge	nudge		VB
nuke	nuke		VB
nullify	nullify		VB
number	number		VB
numb	numb		VB
numerate	numerate		VB
nurse	nurse		VB
nurture	nurture		VB
nutate	nutate		VB
nut	nut		VB
nutrify	nutrify		VB
nuzzle	nuzzle		VB
obey	obey		VB
obfuscate	obfuscate		VB
objectify	objectify		VB
object	object		VB
objurgate	objurgate		VB
obligate	obligate		VB
oblige	oblige		VB
obliterate	obliterate		VB
obnubilate	obnubilate		VB
obscure	obscure		VB
observe	observe		VB
obsess	obsess		VB
obsolesce	obsolesce		VB
obstinate	obstinate		VB
obstipate	obstipate		VB
obstruct	obstruct		VB
obtain	obtain		VB
obtrude	obtrude		VB
obtund	obtund		VB
obturate	obturate		VB
obviate	obviate		VB
occasion	occasion		VB
occidentalise	occidentalise		VB
occidentalize	occidentalize		VB
occlude	occlude		VB
occult	occult		VB
occupy	occupy		VB
occur	occur		VB
o.d.	o.d.		VB
odorize	odorize		VB
odourise	odourise		VB
offend	offend		VB
offer	offer		VB
officer	officer		VB
officialise	officialise		VB
officialize	officialize		VB
officiate	officiate		VB
offload	offload		VB
off	off		VB
offsaddle	offsaddle		VB
offset	offset		VB
ogle	ogle		VB
oil	oil		VB
oink	oink		VB
okay	okay		VB
O.K.	O.K.		VB
omen	omen		VB
omit	omit		VB
one-step	one-step		VB
ooh	ooh		VB
ooze	ooze		VB
opacify	opacify		VB
opalesce	opalesce		VB
opalise	opalise		VB
opalize	opalize		VB
open	open		VB
operate	operate		VB
opine	opine		VB
oppose	oppose		VB
oppress	oppress		VB
oppugn	oppugn		VB
opsonize	opsonize		VB
optimise	optimise		VB
optimize	optimize		VB
opt	opt		VB
orate	orate		VB
orbit	orbit		VB
orb	orb		VB
orchestrate	orchestrate		VB
ordain	ordain		VB
order	order		VB
ordinate	ordinate		VB
organise	organise		VB
organize	organize		VB
orientalise	orientalise		VB
orientalize	orientalize		VB
orientate	orientate		VB
orient	orient		VB
originate	originate		VB
ornament	ornament		VB
orphan	orphan		VB
oscillate	oscillate		VB
osculate	osculate		VB
ossify	ossify		VB
ostentate	ostentate		VB
ostracise	ostracise		VB
ostracize	ostracize		VB
oust	oust		VB
outbalance	outbalance		VB
outbid	outbid		VB
outbrave	outbrave		VB
outcall	outcall		VB
outclass	outclass		VB
outcrop	outcrop		VB
outcry	outcry		VB
outdistance	outdistance		VB
outdo	outdo		VB
outdraw	outdraw		VB
outface	outface		VB
outfight	outfight		VB
outfit	outfit		VB
outflank	outflank		VB
outfox	outfox		VB
outgeneral	outgeneral		VB
outgo	outgo		VB
outgrow	outgrow		VB
outguess	outguess		VB
out-herod	out-herod		VB
outlast	outlast		VB
outlaw	outlaw		VB
outline	outline		VB
outlive	outlive		VB
outmaneuver	outmaneuver		VB
outmanoeuvre	outmanoeuvre		VB
outmarch	outmarch		VB
outmatch	outmatch		VB
outmode	outmode		VB
outnumber	outnumber		VB
out	out		VB
outpace	outpace		VB
outperform	outperform		VB
outplay	outplay		VB
outpoint	outpoint		VB
output	output		VB
outrage	outrage		VB
outrange	outrange		VB
outrank	outrank		VB
outride	outride		VB
outrival	outrival		VB
outroar	outroar		VB
outrun	outrun		VB
outsail	outsail		VB
outscore	outscore		VB
outsell	outsell		VB
outshine	outshine		VB
outshout	outshout		VB
outsmart	outsmart		VB
outsource	outsource		VB
outspan	outspan		VB
outstare	outstare		VB
outstay	outstay		VB
outstrip	outstrip		VB
outvie	outvie		VB
outvote	outvote		VB
outwear	outwear		VB
outweigh	outweigh		VB
outwit	outwit		VB
ovenbake	ovenbake		VB
overachieve	overachieve		VB
overact	overact		VB
overarch	overarch		VB
overawe	overawe		VB
overbalance	overbalance		VB
overbear	overbear		VB
overbid	overbid		VB
overboil	overboil		VB
overburden	overburden		VB
overcapitalise	overcapitalise		VB
overcapitalize	overcapitalize		VB
overcast	overcast		VB
overcharge	overcharge		VB
overclothe	overclothe		VB
overcloud	overcloud		VB
overcome	overcome		VB
overcompensate	overcompensate		VB
overcook	overcook		VB
over-correct	over-correct		VB
overcrop	overcrop		VB
overcrowd	overcrowd		VB
overcultivate	overcultivate		VB
overdo	overdo		VB
overdose	overdose		VB
overdramatise	overdramatise		VB
overdramatize	overdramatize		VB
overdraw	overdraw		VB
overdress	overdress		VB
overdrive	overdrive		VB
overeat	overeat		VB
overemphasise	overemphasise		VB
overemphasize	overemphasize		VB
overestimate	overestimate		VB
overexert	overexert		VB
overexploit	overexploit		VB
overexpose	overexpose		VB
overextend	overextend		VB
overfatigue	overfatigue		VB
overfeed	overfeed		VB
overfill	overfill		VB
overflow	overflow		VB
overfly	overfly		VB
overgeneralise	overgeneralise		VB
overgeneralize	overgeneralize		VB
overgorge	overgorge		VB
overgrow	overgrow		VB
overhang	overhang		VB
overhaul	overhaul		VB
overhear	overhear		VB
overheat	overheat		VB
overindulge	overindulge		VB
overjoy	overjoy		VB
overlap	overlap		VB
overlay	overlay		VB
overleap	overleap		VB
overlie	overlie		VB
overload	overload		VB
overlook	overlook		VB
overmaster	overmaster		VB
overpay	overpay		VB
overplay	overplay		VB
overpopulate	overpopulate		VB
overpower	overpower		VB
overpraise	overpraise		VB
overprice	overprice		VB
overprint	overprint		VB
overproduce	overproduce		VB
overprotect	overprotect		VB
overrate	overrate		VB
overreach	overreach		VB
overreact	overreact		VB
over-refine	over-refine		VB
overrefine	overrefine		VB
override	override		VB
overrule	overrule		VB
overrun	overrun		VB
oversee	oversee		VB
oversew	oversew		VB
overshadow	overshadow		VB
overshoot	overshoot		VB
oversimplify	oversimplify		VB
oversleep	oversleep		VB
overspecialise	overspecialise		VB
overspecialize	overspecialize		VB
overspend	overspend		VB
overspread	overspread		VB
overstate	overstate		VB
overstay	overstay		VB
overstep	overstep		VB
overstock	overstock		VB
overstrain	overstrain		VB
overstress	overstress		VB
overstretch	overstretch		VB
overstuff	overstuff		VB
oversupply	oversupply		VB
overtake	overtake		VB
overtax	overtax		VB
overthrow	overthrow		VB
overtire	overtire		VB
overtop	overtop		VB
overtrump	overtrump		VB
overturn	overturn		VB
overuse	overuse		VB
overvalue	overvalue		VB
overweary	overweary		VB
overwhelm	overwhelm		VB
overwinter	overwinter		VB
overwork	overwork		VB
overwrite	overwrite		VB
ovulate	ovulate		VB
owe	owe		VB
own	own		VB
oxidate	oxidate		VB
oxidise	oxidise		VB
oxidize	oxidize		VB
oxygenate	oxygenate		VB
oxygenise	oxygenise		VB
oxygenize	oxygenize		VB
oyster	oyster		VB
ozonise	ozonise		VB
ozonize	ozonize		VB
pace	pace		VB
pacify	pacify		VB
package	package		VB
pack	pack		VB
paddle	paddle		VB
padlock	padlock		VB
pad	pad		VB
paganise	paganise		VB
paganize	paganize		VB
page	page		VB
paginate	paginate		VB
pain	pain		VB
paint	paint		VB
pair	pair		VB
palatalise	palatalise		VB
palatalize	palatalize		VB
palaver	palaver		VB
pale	pale		VB
palisade	palisade		VB
palliate	palliate		VB
pall	pall		VB
palm	palm		VB
pal	pal		VB
palpate	palpate		VB
palpebrate	palpebrate		VB
palpitate	palpitate		VB
palsy	palsy		VB
palter	palter		VB
pamper	pamper		VB
pan-broil	pan-broil		VB
pander	pander		VB
panel	panel		VB
pan-fry	pan-fry		VB
panhandle	panhandle		VB
panic	panic		VB
pan	pan		VB
pant-hoot	pant-hoot		VB
pantomime	pantomime		VB
pant	pant		VB
paper	paper		VB
parachute	parachute		VB
parade	parade		VB
paragraph	paragraph		VB
parallelize	parallelize		VB
parallel	parallel		VB
parallel-park	parallel-park		VB
paralyse	paralyse		VB
paralyze	paralyze		VB
paraphrase	paraphrase		VB
parboil	parboil		VB
parcel	parcel		VB
parch	parch		VB
pardon	pardon		VB
parent	parent		VB
pare	pare		VB
parget	parget		VB
park	park		VB
parlay	parlay		VB
parley	parley		VB
parody	parody		VB
parole	parole		VB
par	par		VB
parrot	parrot		VB
parry	parry		VB
parse	parse		VB
partake	partake		VB
participate	participate		VB
parti-color	parti-color		VB
particularise	particularise		VB
particularize	particularize		VB
partition	partition		VB
partner	partner		VB
part	part		VB
party	party		VB
pass	pass		VB
paste	paste		VB
pasteurise	pasteurise		VB
pasteurize	pasteurize		VB
pasture	pasture		VB
patch	patch		VB
patent	patent		VB
patinate	patinate		VB
patinise	patinise		VB
patinize	patinize		VB
pat	pat		VB
patrol	patrol		VB
patronage	patronage		VB
patronise	patronise		VB
patronize	patronize		VB
pattern-bomb	pattern-bomb		VB
pattern	pattern		VB
patter	patter		VB
pauperise	pauperise		VB
pauperize	pauperize		VB
pause	pause		VB
pave	pave		VB
pawn	pawn		VB
paw	paw		VB
pay	pay		VB
peach	peach		VB
peak	peak		VB
peal	peal		VB
pearl	pearl		VB
peck	peck		VB
peculate	peculate		VB
pedal	pedal		VB
peddle	peddle		VB
pedicure	pedicure		VB
peek	peek		VB
peel	peel		VB
pee-pee	pee-pee		VB
pee	pee		VB
peep	peep		VB
peer	peer		VB
peeve	peeve		VB
peg	peg		VB
pelt	pelt		VB
penalise	penalise		VB
penalize	penalize		VB
pencil	pencil		VB
penetrate	penetrate		VB
penny-pinch	penny-pinch		VB
pen	pen		VB
pension	pension		VB
people	people		VB
pepper	pepper		VB
peptise	peptise		VB
peptize	peptize		VB
perambulate	perambulate		VB
perceive	perceive		VB
perch	perch		VB
percolate	percolate		VB
percuss	percuss		VB
peregrinate	peregrinate		VB
perennate	perennate		VB
perfect	perfect		VB
perforate	perforate		VB
perform	perform		VB
perfume	perfume		VB
perfuse	perfuse		VB
peril	peril		VB
perish	perish		VB
perjure	perjure		VB
perk	perk		VB
permeate	permeate		VB
permit	permit		VB
perm	perm		VB
permute	permute		VB
perorate	perorate		VB
peroxide	peroxide		VB
perpetrate	perpetrate		VB
perpetuate	perpetuate		VB
perplex	perplex		VB
persecute	persecute		VB
perseverate	perseverate		VB
persevere	persevere		VB
persist	persist		VB
personalise	personalise		VB
personalize	personalize		VB
personate	personate		VB
personify	personify		VB
perspire	perspire		VB
persuade	persuade		VB
pertain	pertain		VB
perturb	perturb		VB
peruse	peruse		VB
pervade	pervade		VB
pervaporate	pervaporate		VB
pervert	pervert		VB
pester	pester		VB
pestle	pestle		VB
petition	petition		VB
pet	pet		VB
petrify	petrify		VB
pettifog	pettifog		VB
phase	phase		VB
philander	philander		VB
philosophise	philosophise		VB
philosophize	philosophize		VB
phlebotomise	phlebotomise		VB
phlebotomize	phlebotomize		VB
phonate	phonate		VB
phone	phone		VB
phosphoresce	phosphoresce		VB
photocopy	photocopy		VB
photograph	photograph		VB
photosensitise	photosensitise		VB
photosensitize	photosensitize		VB
photostat	photostat		VB
phrase	phrase		VB
picket	picket		VB
pickle	pickle		VB
pick	pick		VB
picnic	picnic		VB
picture	picture		VB
piddle	piddle		VB
piece-dye	piece-dye		VB
piece	piece		VB
pierce	pierce		VB
piffle	piffle		VB
pigeonhole	pigeonhole		VB
piggyback	piggyback		VB
pigment	pigment		VB
pig	pig		VB
pile	pile		VB
pilfer	pilfer		VB
pillage	pillage		VB
pillory	pillory		VB
pillow	pillow		VB
pilot	pilot		VB
pimp	pimp		VB
pinch	pinch		VB
pine	pine		VB
ping	ping		VB
pinion	pinion		VB
pinkify	pinkify		VB
pink	pink		VB
pinnacle	pinnacle		VB
pin	pin		VB
pinpoint	pinpoint		VB
pioneer	pioneer		VB
pipe-clay	pipe-clay		VB
pipe	pipe		VB
pip	pip		VB
pique	pique		VB
pirate	pirate		VB
pirouette	pirouette		VB
piss	piss		VB
pistol-whip	pistol-whip		VB
pitchfork	pitchfork		VB
pitch	pitch		VB
pith	pith		VB
pit	pit		VB
pitter-patter	pitter-patter		VB
pity	pity		VB
pivot	pivot		VB
placard	placard		VB
placate	placate		VB
place-kick	place-kick		VB
place	place		VB
plagiarise	plagiarise		VB
plagiarize	plagiarize		VB
plague	plague		VB
plain	plain		VB
plait	plait		VB
plane	plane		VB
plank	plank		VB
plan	plan		VB
plant	plant		VB
plash	plash		VB
plaster	plaster		VB
plasticise	plasticise		VB
plasticize	plasticize		VB
plastinate	plastinate		VB
plate	plate		VB
platinize	platinize		VB
platitudinize	platitudinize		VB
plat	plat		VB
playact	playact		VB
play	play		VB
plea-bargain	plea-bargain		VB
pleach	pleach		VB
plead	plead		VB
please	please		VB
pleat	pleat		VB
pledge	pledge		VB
plicate	plicate		VB
plight	plight		VB
plod	plod		VB
plonk	plonk		VB
plop	plop		VB
plot	plot		VB
plough	plough		VB
plow	plow		VB
pluck	pluck		VB
plug	plug		VB
plumb	plumb		VB
plume	plume		VB
plummet	plummet		VB
plump	plump		VB
plunder	plunder		VB
plunge	plunge		VB
plunk	plunk		VB
pluralise	pluralise		VB
pluralize	pluralize		VB
ply	ply		VB
poach	poach		VB
pocket	pocket		VB
pockmark	pockmark		VB
pock	pock		VB
podcast	podcast		VB
pod	pod		VB
poetise	poetise		VB
poetize	poetize		VB
point	point		VB
poise	poise		VB
poison	poison		VB
poke	poke		VB
polarise	polarise		VB
polarize	polarize		VB
poleaxe	poleaxe		VB
poleax	poleax		VB
polemicise	polemicise		VB
polemicize	polemicize		VB
polemise	polemise		VB
polemize	polemize		VB
pole	pole		VB
police	police		VB
polish	polish		VB
politicise	politicise		VB
politicize	politicize		VB
politick	politick		VB
polka	polka		VB
pollard	pollard		VB
pollenate	pollenate		VB
pollinate	pollinate		VB
poll	poll		VB
pollute	pollute		VB
polychrome	polychrome		VB
polychromise	polychromise		VB
polychromize	polychromize		VB
polymerise	polymerise		VB
polymerize	polymerize		VB
pomade	pomade		VB
pommel	pommel		VB
pompadour	pompadour		VB
ponder	ponder		VB
poniard	poniard		VB
pontificate	pontificate		VB
pooch	pooch		VB
pooh-pooh	pooh-pooh		VB
pool	pool		VB
pop	pop		VB
popularise	popularise		VB
popularize	popularize		VB
populate	populate		VB
porcelainize	porcelainize		VB
pore	pore		VB
portend	portend		VB
porter	porter		VB
portion	portion		VB
port	port		VB
portray	portray		VB
pose	pose		VB
position	position		VB
posit	posit		VB
possess	possess		VB
postdate	postdate		VB
postmark	postmark		VB
postpone	postpone		VB
postpose	postpose		VB
post	post		VB
postulate	postulate		VB
posture	posture		VB
potentiate	potentiate		VB
pother	pother		VB
pot	pot		VB
potter	potter		VB
pouch	pouch		VB
poultice	poultice		VB
pounce	pounce		VB
pound	pound		VB
pour	pour		VB
pout	pout		VB
powderise	powderise		VB
powderize	powderize		VB
powder	powder		VB
power-dive	power-dive		VB
power	power		VB
powerwash	powerwash		VB
powwow	powwow		VB
practice	practice		VB
practise	practise		VB
praise	praise		VB
prance	prance		VB
prang	prang		VB
prank	prank		VB
prate	prate		VB
prattle	prattle		VB
prawn	prawn		VB
pray	pray		VB
preachify	preachify		VB
preach	preach		VB
preamble	preamble		VB
prearrange	prearrange		VB
preassemble	preassemble		VB
precede	precede		VB
precess	precess		VB
precipitate	precipitate		VB
precis	precis		VB
preclude	preclude		VB
preconceive	preconceive		VB
precondition	precondition		VB
precook	precook		VB
predate	predate		VB
predecease	predecease		VB
predestinate	predestinate		VB
predestine	predestine		VB
predetermine	predetermine		VB
predicate	predicate		VB
predict	predict		VB
predigest	predigest		VB
predispose	predispose		VB
predominate	predominate		VB
preempt	preempt		VB
preen	preen		VB
preexist	preexist		VB
prefabricate	prefabricate		VB
preface	preface		VB
prefer	prefer		VB
prefigure	prefigure		VB
prefix	prefix		VB
preform	preform		VB
preheat	preheat		VB
prehend	prehend		VB
preisolate	preisolate		VB
prejudge	prejudge		VB
prejudice	prejudice		VB
prelude	prelude		VB
premeditate	premeditate		VB
premiere	premiere		VB
premier	premier		VB
premise	premise		VB
premiss	premiss		VB
preoccupy	preoccupy		VB
preordain	preordain		VB
prepare	prepare		VB
prepay	prepay		VB
preponderate	preponderate		VB
prepose	prepose		VB
prepossess	prepossess		VB
prerecord	prerecord		VB
presage	presage		VB
prescribe	prescribe		VB
present	present		VB
preserve	preserve		VB
preside	preside		VB
press	press		VB
pressure-cook	pressure-cook		VB
pressure	pressure		VB
pressure-wash	pressure-wash		VB
pressurise	pressurise		VB
pressurize	pressurize		VB
presume	presume		VB
presuppose	presuppose		VB
pretend	pretend		VB
pretermit	pretermit		VB
prettify	prettify		VB
prevail	prevail		VB
prevaricate	prevaricate		VB
prevent	prevent		VB
preview	preview		VB
previse	previse		VB
prey	prey		VB
price	price		VB
prickle	prickle		VB
prick	prick		VB
pride	pride		VB
prime	prime		VB
primp	primp		VB
prim	prim		VB
prink	prink		VB
print	print		VB
prioritise	prioritise		VB
prioritize	prioritize		VB
prise	prise		VB
privatise	privatise		VB
privatize	privatize		VB
privilege	privilege		VB
prizefight	prizefight		VB
prize	prize		VB
probate	probate		VB
probe	probe		VB
proceed	proceed		VB
process	process		VB
proclaim	proclaim		VB
procrastinate	procrastinate		VB
procreate	procreate		VB
proctor	proctor		VB
procure	procure		VB
prod	prod		VB
produce	produce		VB
profane	profane		VB
professionalise	professionalise		VB
professionalize	professionalize		VB
profess	profess		VB
proffer	proffer		VB
profile	profile		VB
profiteer	profiteer		VB
profit	profit		VB
prognosticate	prognosticate		VB
programme	programme		VB
program	program		VB
progress	progress		VB
prohibit	prohibit		VB
project	project		VB
prolapse	prolapse		VB
proliferate	proliferate		VB
prologise	prologise		VB
prologize	prologize		VB
prologuize	prologuize		VB
prolong	prolong		VB
promenade	promenade		VB
promise	promise		VB
promote	promote		VB
prompt	prompt		VB
promulgate	promulgate		VB
pronate	pronate		VB
pronk	pronk		VB
pronounce	pronounce		VB
proof	proof		VB
proofread	proofread		VB
propagandise	propagandise		VB
propagandize	propagandize		VB
propagate	propagate		VB
propel	propel		VB
prophesy	prophesy		VB
propitiate	propitiate		VB
proportion	proportion		VB
propose	propose		VB
proposition	proposition		VB
propound	propound		VB
prop	prop		VB
prorate	prorate		VB
prorogue	prorogue		VB
proscribe	proscribe		VB
prosecute	prosecute		VB
proselytise	proselytise		VB
proselytize	proselytize		VB
prospect	prospect		VB
prosper	prosper		VB
prostitute	prostitute		VB
prostrate	prostrate		VB
protect	protect		VB
protest	protest		VB
protract	protract		VB
protrude	protrude		VB
protuberate	protuberate		VB
prove	prove		VB
provide	provide		VB
provision	provision		VB
provoke	provoke		VB
prowl	prowl		VB
prune	prune		VB
pry	pry		VB
psalm	psalm		VB
psychoanalyse	psychoanalyse		VB
psychoanalyze	psychoanalyze		VB
ptyalise	ptyalise		VB
ptyalize	ptyalize		VB
pub-crawl	pub-crawl		VB
publicise	publicise		VB
publicize	publicize		VB
publish	publish		VB
pucker	pucker		VB
puddle	puddle		VB
puff	puff		VB
puke	puke		VB
pule	pule		VB
pull	pull		VB
pullulate	pullulate		VB
pulp	pulp		VB
pulsate	pulsate		VB
pulse	pulse		VB
pulverise	pulverise		VB
pulverize	pulverize		VB
pumice	pumice		VB
pummel	pummel		VB
pump	pump		VB
punch	punch		VB
punctuate	punctuate		VB
puncture	puncture		VB
punish	punish		VB
pun	pun		VB
punt	punt		VB
pupate	pupate		VB
pup	pup		VB
purchase	purchase		VB
puree	puree		VB
purge	purge		VB
purify	purify		VB
purloin	purloin		VB
purl	purl		VB
purple	purple		VB
purport	purport		VB
purpose	purpose		VB
purpurate	purpurate		VB
purr	purr		VB
purse	purse		VB
pursue	pursue		VB
purvey	purvey		VB
push	push		VB
pussyfoot	pussyfoot		VB
put	put		VB
putrefy	putrefy		VB
putter	putter		VB
putt	putt		VB
putty	putty		VB
puzzle	puzzle		VB
pyramid	pyramid		VB
quack	quack		VB
quadruple	quadruple		VB
quadruplicate	quadruplicate		VB
quaff	quaff		VB
quail	quail		VB
quake	quake		VB
qualify	qualify		VB
quantify	quantify		VB
quantise	quantise		VB
quantize	quantize		VB
quarantine	quarantine		VB
quarrel	quarrel		VB
quarry	quarry		VB
quarterback	quarterback		VB
quarter	quarter		VB
quash	quash		VB
quaver	quaver		VB
queen	queen		VB
queer	queer		VB
quell	quell		VB
quench	quench		VB
query	query		VB
question	question		VB
quest	quest		VB
quetch	quetch		VB
queue	queue		VB
quibble	quibble		VB
quicken	quicken		VB
quick-freeze	quick-freeze		VB
quickstep	quickstep		VB
quiesce	quiesce		VB
quieten	quieten		VB
quiet	quiet		VB
quilt	quilt		VB
quintuple	quintuple		VB
quip	quip		VB
quirk	quirk		VB
quit	quit		VB
quiver	quiver		VB
quiz	quiz		VB
quote	quote		VB
rabbet	rabbet		VB
rabbit	rabbit		VB
race	race		VB
racketeer	racketeer		VB
racket	racket		VB
rack	rack		VB
raddle	raddle		VB
radiate	radiate		VB
radicalize	radicalize		VB
radiolocate	radiolocate		VB
radio	radio		VB
raffle	raffle		VB
rafter	rafter		VB
raft	raft		VB
rage	rage		VB
rag	rag		VB
raid	raid		VB
rail	rail		VB
railroad	railroad		VB
raiment	raiment		VB
rain	rain		VB
raise	raise		VB
rake	rake		VB
rally	rally		VB
ramble	ramble		VB
ramify	ramify		VB
rampage	rampage		VB
ramp	ramp		VB
ram	ram		VB
ranch	ranch		VB
randomise	randomise		VB
randomize	randomize		VB
range	range		VB
rankle	rankle		VB
rank	rank		VB
ransack	ransack		VB
ransom	ransom		VB
rant	rant		VB
rape	rape		VB
rappel	rappel		VB
rap	rap		VB
rarefy	rarefy		VB
rarify	rarify		VB
rase	rase		VB
rasp	rasp		VB
rasterize	rasterize		VB
ratchet	ratchet		VB
rate	rate		VB
ratify	ratify		VB
ratiocinate	ratiocinate		VB
rationalise	rationalise		VB
rationalize	rationalize		VB
ration	ration		VB
rat	rat		VB
rattle	rattle		VB
ravage	ravage		VB
ravel	ravel		VB
raven	raven		VB
rave	rave		VB
ravish	ravish		VB
ray	ray		VB
raze	raze		VB
razor	razor		VB
razz	razz		VB
reabsorb	reabsorb		VB
reach	reach		VB
reacquaint	reacquaint		VB
reactivate	reactivate		VB
react	react		VB
readapt	readapt		VB
re-address	re-address		VB
readjust	readjust		VB
readmit	readmit		VB
read	read		VB
ready	ready		VB
reaffirm	reaffirm		VB
re-afforest	re-afforest		VB
realign	realign		VB
realine	realine		VB
realise	realise		VB
realize	realize		VB
reallocate	reallocate		VB
reallot	reallot		VB
ream	ream		VB
reanimate	reanimate		VB
reappear	reappear		VB
reapportion	reapportion		VB
reappraise	reappraise		VB
reap	reap		VB
rear-end	rear-end		VB
re-argue	re-argue		VB
re-arm	re-arm		VB
rearm	rearm		VB
rearrange	rearrange		VB
rear	rear		VB
reason	reason		VB
reassail	reassail		VB
reassemble	reassemble		VB
reassert	reassert		VB
reassess	reassess		VB
reassign	reassign		VB
re-assume	re-assume		VB
reassure	reassure		VB
reattribute	reattribute		VB
reave	reave		VB
reawaken	reawaken		VB
rebate	rebate		VB
rebel	rebel		VB
rebind	rebind		VB
reboot	reboot		VB
rebound	rebound		VB
rebroadcast	rebroadcast		VB
rebuff	rebuff		VB
rebuild	rebuild		VB
rebuke	rebuke		VB
rebury	rebury		VB
rebut	rebut		VB
recalcitrate	recalcitrate		VB
recalculate	recalculate		VB
recall	recall		VB
recant	recant		VB
recapitulate	recapitulate		VB
recap	recap		VB
recapture	recapture		VB
recast	recast		VB
recede	recede		VB
receipt	receipt		VB
receive	receive		VB
recess	recess		VB
recharge	recharge		VB
recidivate	recidivate		VB
reciprocate	reciprocate		VB
recite	recite		VB
reckon	reckon		VB
reclaim	reclaim		VB
reclassify	reclassify		VB
recline	recline		VB
recode	recode		VB
recognise	recognise		VB
recognize	recognize		VB
recoil	recoil		VB
recollect	recollect		VB
recombine	recombine		VB
recommence	recommence		VB
recommend	recommend		VB
recommit	recommit		VB
recompense	recompense		VB
reconcile	reconcile		VB
recondition	recondition		VB
reconfirm	reconfirm		VB
reconnoiter	reconnoiter		VB
reconnoitre	reconnoitre		VB
reconquer	reconquer		VB
reconsecrate	reconsecrate		VB
reconsider	reconsider		VB
reconstitute	reconstitute		VB
reconstruct	reconstruct		VB
reconvene	reconvene		VB
reconvert	reconvert		VB
reconvict	reconvict		VB
recopy	recopy		VB
record	record		VB
recount	recount		VB
recoup	recoup		VB
recover	recover		VB
re-create	re-create		VB
recreate	recreate		VB
recriminate	recriminate		VB
recrudesce	recrudesce		VB
recruit	recruit		VB
rectify	rectify		VB
recumb	recumb		VB
recuperate	recuperate		VB
recur	recur		VB
recurve	recurve		VB
recuse	recuse		VB
recycle	recycle		VB
redact	redact		VB
redden	redden		VB
redecorate	redecorate		VB
rededicate	rededicate		VB
redeem	redeem		VB
redefine	redefine		VB
redeploy	redeploy		VB
redeposit	redeposit		VB
rede	rede		VB
redesign	redesign		VB
redetermine	redetermine		VB
redevelop	redevelop		VB
red-eye	red-eye		VB
red-ink	red-ink		VB
redirect	redirect		VB
rediscover	rediscover		VB
redispose	redispose		VB
redistribute	redistribute		VB
redline	redline		VB
redo	redo		VB
redouble	redouble		VB
redound	redound		VB
redress	redress		VB
reduce	reduce		VB
reduplicate	reduplicate		VB
reecho	reecho		VB
reef	reef		VB
reek	reek		VB
reelect	reelect		VB
reel	reel		VB
re-emerge	re-emerge		VB
re-emphasise	re-emphasise		VB
re-emphasize	re-emphasize		VB
reenact	reenact		VB
reenforce	reenforce		VB
re-enter	re-enter		VB
re-equip	re-equip		VB
reestablish	reestablish		VB
reevaluate	reevaluate		VB
reeve	reeve		VB
re-examine	re-examine		VB
reexamine	reexamine		VB
re-explain	re-explain		VB
re-explore	re-explore		VB
reface	reface		VB
refashion	refashion		VB
referee	referee		VB
reference	reference		VB
refer	refer		VB
refill	refill		VB
refinance	refinance		VB
refine	refine		VB
refinish	refinish		VB
refit	refit		VB
reflate	reflate		VB
reflectorise	reflectorise		VB
reflectorize	reflectorize		VB
reflect	reflect		VB
refloat	refloat		VB
refocus	refocus		VB
reforest	reforest		VB
reforge	reforge		VB
reform	reform		VB
reformulate	reformulate		VB
refract	refract		VB
refracture	refracture		VB
refrain	refrain		VB
refreshen	refreshen		VB
refresh	refresh		VB
refrigerate	refrigerate		VB
refuel	refuel		VB
refund	refund		VB
refurbish	refurbish		VB
refurnish	refurnish		VB
refuse	refuse		VB
refute	refute		VB
regain	regain		VB
regale	regale		VB
regard	regard		VB
regenerate	regenerate		VB
regiment	regiment		VB
register	register		VB
regorge	regorge		VB
regress	regress		VB
regret	regret		VB
regroup	regroup		VB
regrow	regrow		VB
regularise	regularise		VB
regularize	regularize		VB
regulate	regulate		VB
regurgitate	regurgitate		VB
rehabilitate	rehabilitate		VB
reharmonise	reharmonise		VB
reharmonize	reharmonize		VB
rehash	rehash		VB
rehear	rehear		VB
rehearse	rehearse		VB
reheat	reheat		VB
reheel	reheel		VB
rehouse	rehouse		VB
reify	reify		VB
reignite	reignite		VB
reign	reign		VB
reimburse	reimburse		VB
reimpose	reimpose		VB
reincarnate	reincarnate		VB
re-incorporate	re-incorporate		VB
reinforce	reinforce		VB
rein	rein		VB
reinstall	reinstall		VB
reinstate	reinstate		VB
reinsure	reinsure		VB
reintegrate	reintegrate		VB
reinterpret	reinterpret		VB
re-introduce	re-introduce		VB
reintroduce	reintroduce		VB
reinvent	reinvent		VB
reinvigorate	reinvigorate		VB
reissue	reissue		VB
reiterate	reiterate		VB
reject	reject		VB
rejig	rejig		VB
rejoice	rejoice		VB
rejoin	rejoin		VB
rejuvenate	rejuvenate		VB
rekindle	rekindle		VB
relace	relace		VB
relapse	relapse		VB
relate	relate		VB
relativise	relativise		VB
relativize	relativize		VB
relax	relax		VB
relay	relay		VB
relearn	relearn		VB
release	release		VB
relegate	relegate		VB
relent	relent		VB
relieve	relieve		VB
reline	reline		VB
relinquish	relinquish		VB
relish	relish		VB
relive	relive		VB
reload	reload		VB
relocate	relocate		VB
rely	rely		VB
relyric	relyric		VB
remainder	remainder		VB
remain	remain		VB
remake	remake		VB
remand	remand		VB
remark	remark		VB
remarry	remarry		VB
remediate	remediate		VB
remedy	remedy		VB
remember	remember		VB
remilitarise	remilitarise		VB
remilitarize	remilitarize		VB
remind	remind		VB
reminisce	reminisce		VB
remit	remit		VB
remodel	remodel		VB
remold	remold		VB
remonstrate	remonstrate		VB
remould	remould		VB
remount	remount		VB
remove	remove		VB
remunerate	remunerate		VB
rename	rename		VB
render	render		VB
render-set	render-set		VB
rendezvous	rendezvous		VB
rend	rend		VB
renegade	renegade		VB
renege	renege		VB
renegociate	renegociate		VB
renegotiate	renegotiate		VB
renew	renew		VB
renormalise	renormalise		VB
renormalize	renormalize		VB
renounce	renounce		VB
renovate	renovate		VB
rent	rent		VB
reopen	reopen		VB
reorder	reorder		VB
reorganise	reorganise		VB
reorganize	reorganize		VB
reorientate	reorientate		VB
reorient	reorient		VB
repaint	repaint		VB
repair	repair		VB
repatriate	repatriate		VB
repay	repay		VB
repeal	repeal		VB
repeat	repeat		VB
repel	repel		VB
repent	repent		VB
repercuss	repercuss		VB
rephrase	rephrase		VB
repine	repine		VB
replace	replace		VB
replant	replant		VB
replay	replay		VB
replenish	replenish		VB
replete	replete		VB
replicate	replicate		VB
reply	reply		VB
repoint	repoint		VB
report	report		VB
repose	repose		VB
reposition	reposition		VB
reposit	reposit		VB
repossess	repossess		VB
repot	repot		VB
reprehend	reprehend		VB
represent	represent		VB
repress	repress		VB
reprieve	reprieve		VB
reprimand	reprimand		VB
reprint	reprint		VB
reprise	reprise		VB
reprize	reprize		VB
reproach	reproach		VB
reprobate	reprobate		VB
reprocess	reprocess		VB
reproduce	reproduce		VB
reproof	reproof		VB
reprove	reprove		VB
republish	republish		VB
repudiate	repudiate		VB
repugn	repugn		VB
repulse	repulse		VB
repurchase	repurchase		VB
repute	repute		VB
request	request		VB
require	require		VB
requisition	requisition		VB
requite	requite		VB
reread	reread		VB
rerun	rerun		VB
rescale	rescale		VB
reschedule	reschedule		VB
rescind	rescind		VB
rescue	rescue		VB
reseal	reseal		VB
research	research		VB
reseat	reseat		VB
resect	resect		VB
reseed	reseed		VB
resell	resell		VB
resemble	resemble		VB
resent	resent		VB
reserve	reserve		VB
reset	reset		VB
resettle	resettle		VB
resew	resew		VB
reshape	reshape		VB
reship	reship		VB
reshoot	reshoot		VB
reshuffle	reshuffle		VB
reside	reside		VB
resift	resift		VB
resign	resign		VB
resile	resile		VB
resinate	resinate		VB
resist	resist		VB
resize	resize		VB
resmudge	resmudge		VB
resole	resole		VB
resolve	resolve		VB
resonate	resonate		VB
resorb	resorb		VB
resort	resort		VB
resound	resound		VB
respect	respect		VB
respire	respire		VB
respite	respite		VB
resplend	resplend		VB
respond	respond		VB
re-start	re-start		VB
restart	restart		VB
restate	restate		VB
restitute	restitute		VB
restock	restock		VB
restore	restore		VB
restrain	restrain		VB
restrengthen	restrengthen		VB
rest	rest		VB
restrict	restrict		VB
restructure	restructure		VB
resublime	resublime		VB
resubmit	resubmit		VB
result	result		VB
resume	resume		VB
resurface	resurface		VB
resurge	resurge		VB
resurrect	resurrect		VB
resuscitate	resuscitate		VB
resuspend	resuspend		VB
retail	retail		VB
retain	retain		VB
retake	retake		VB
retaliate	retaliate		VB
retard	retard		VB
retch	retch		VB
retell	retell		VB
rethink	rethink		VB
retick	retick		VB
reticulate	reticulate		VB
retie	retie		VB
retire	retire		VB
retool	retool		VB
retort	retort		VB
retouch	retouch		VB
retrace	retrace		VB
retract	retract		VB
retrain	retrain		VB
retranslate	retranslate		VB
retransmit	retransmit		VB
retread	retread		VB
retreat	retreat		VB
retrench	retrench		VB
ret	ret		VB
retrieve	retrieve		VB
retrofit	retrofit		VB
retroflex	retroflex		VB
retrograde	retrograde		VB
retrogress	retrogress		VB
retrospect	retrospect		VB
retrovert	retrovert		VB
retry	retry		VB
return	return		VB
reunify	reunify		VB
reunite	reunite		VB
reuse	reuse		VB
revalue	revalue		VB
revamp	revamp		VB
reveal	reveal		VB
revel	revel		VB
revenge	revenge		VB
reverberate	reverberate		VB
reverence	reverence		VB
revere	revere		VB
reverse	reverse		VB
revert	revert		VB
revet	revet		VB
review	review		VB
revile	revile		VB
revise	revise		VB
revisit	revisit		VB
revitalise	revitalise		VB
revitalize	revitalize		VB
revive	revive		VB
revivify	revivify		VB
revoke	revoke		VB
revolt	revolt		VB
revolutionise	revolutionise		VB
revolutionize	revolutionize		VB
revolve	revolve		VB
rev	rev		VB
reward	reward		VB
rewire	rewire		VB
reword	reword		VB
rework	rework		VB
rewrite	rewrite		VB
rhapsodise	rhapsodise		VB
rhapsodize	rhapsodize		VB
rhumba	rhumba		VB
rhyme	rhyme		VB
rib	rib		VB
rice	rice		VB
rick	rick		VB
ricochet	ricochet		VB
riddle	riddle		VB
ride	ride		VB
ridge	ridge		VB
ridicule	ridicule		VB
rid	rid		VB
riffle	riffle		VB
riff	riff		VB
rifle	rifle		VB
right	right		VB
rigidify	rigidify		VB
rig	rig		VB
rile	rile		VB
rime	rime		VB
rim	rim		VB
ring	ring		VB
rinse	rinse		VB
riot	riot		VB
ripen	ripen		VB
riposte	riposte		VB
ripple	ripple		VB
rip	rip		VB
rise	rise		VB
risk	risk		VB
ritualise	ritualise		VB
ritualize	ritualize		VB
rival	rival		VB
rive	rive		VB
rivet	rivet		VB
roach	roach		VB
roam	roam		VB
roar	roar		VB
roast	roast		VB
robe	robe		VB
rob	rob		VB
rocket	rocket		VB
rock	rock		VB
roil	roil		VB
roister	roister		VB
roleplay	roleplay		VB
Rollerblade	Rollerblade		VB
rollick	rollick		VB
roll	roll		VB
romance	romance		VB
Romanise	Romanise		VB
Romanize	Romanize		VB
romanticise	romanticise		VB
romanticize	romanticize		VB
romp	romp		VB
roneo	roneo		VB
roof	roof		VB
rook	rook		VB
room	room		VB
roost	roost		VB
rootle	rootle		VB
root	root		VB
rope	rope		VB
rosin	rosin		VB
rotate	rotate		VB
rot	rot		VB
rouge	rouge		VB
roughcast	roughcast		VB
rough-dry	rough-dry		VB
roughen	roughen		VB
rough-hew	rough-hew		VB
rough-house	rough-house		VB
roughhouse	roughhouse		VB
rough	rough		VB
rough-sand	rough-sand		VB
round	round		VB
rouse	rouse		VB
route	route		VB
rout	rout		VB
rove	rove		VB
row	row		VB
rubberise	rubberise		VB
rubberize	rubberize		VB
rubberneck	rubberneck		VB
rubber	rubber		VB
rubberstamp	rubberstamp		VB
rubbish	rubbish		VB
rubify	rubify		VB
rubricate	rubricate		VB
rubric	rubric		VB
rub	rub		VB
ruckle	ruckle		VB
ruck	ruck		VB
ruddle	ruddle		VB
rue	rue		VB
ruffle	ruffle		VB
ruff	ruff		VB
ruggedise	ruggedise		VB
ruggedize	ruggedize		VB
ruin	ruin		VB
rule	rule		VB
rumba	rumba		VB
rumble	rumble		VB
ruminate	ruminate		VB
rummage	rummage		VB
rumor	rumor		VB
rumour	rumour		VB
rumple	rumple		VB
rumpus	rumpus		VB
run	run		VB
rupture	rupture		VB
rush	rush		VB
rusticate	rusticate		VB
rustle	rustle		VB
rust	rust		VB
rut	rut		VB
saber	saber		VB
sabotage	sabotage		VB
sabre	sabre		VB
saccharify	saccharify		VB
sack	sack		VB
sacrifice	sacrifice		VB
sadden	sadden		VB
saddle	saddle		VB
safeguard	safeguard		VB
sag	sag		VB
sailplane	sailplane		VB
sail	sail		VB
saint	saint		VB
salaam	salaam		VB
salinate	salinate		VB
salivate	salivate		VB
sallow	sallow		VB
saltate	saltate		VB
salt	salt		VB
salute	salute		VB
salvage	salvage		VB
salve	salve		VB
samba	samba		VB
sample	sample		VB
sanctify	sanctify		VB
sanction	sanction		VB
sandbag	sandbag		VB
sandblast	sandblast		VB
sandpaper	sandpaper		VB
sand	sand		VB
sandwich	sandwich		VB
sanitate	sanitate		VB
sanitise	sanitise		VB
sanitize	sanitize		VB
saponify	saponify		VB
sap	sap		VB
sashay	sashay		VB
sass	sass		VB
satellite	satellite		VB
sate	sate		VB
satiate	satiate		VB
satirise	satirise		VB
satirize	satirize		VB
satisfice	satisfice		VB
satisfise	satisfise		VB
satisfy	satisfy		VB
saturate	saturate		VB
sauce	sauce		VB
saunter	saunter		VB
saute	saute		VB
savage	savage		VB
save	save		VB
savor	savor		VB
savour	savour		VB
savvy	savvy		VB
saw	saw		VB
say	say		VB
scab	scab		VB
scaffold	scaffold		VB
scald	scald		VB
scale	scale		VB
scallop	scallop		VB
scalp	scalp		VB
scamper	scamper		VB
scamp	scamp		VB
scam	scam		VB
scandalise	scandalise		VB
scandalize	scandalize		VB
scan	scan		VB
scant	scant		VB
scare	scare		VB
scarf	scarf		VB
scarify	scarify		VB
scarper	scarper		VB
scar	scar		VB
scat	scat		VB
scatter	scatter		VB
scavenge	scavenge		VB
scend	scend		VB
scent	scent		VB
schedule	schedule		VB
schematise	schematise		VB
schematize	schematize		VB
scheme	scheme		VB
schlep	schlep		VB
schmoose	schmoose		VB
schmooze	schmooze		VB
schnorr	schnorr		VB
school	school		VB
schuss	schuss		VB
scintillate	scintillate		VB
scissor	scissor		VB
sclaff	sclaff		VB
scoff	scoff		VB
scold	scold		VB
scollop	scollop		VB
scoop	scoop		VB
scoot	scoot		VB
scorch	scorch		VB
score	score		VB
scorn	scorn		VB
scotch	scotch		VB
scourge	scourge		VB
scour	scour		VB
scout	scout		VB
scowl	scowl		VB
scrabble	scrabble		VB
scrag	scrag		VB
scramble	scramble		VB
scram	scram		VB
scranch	scranch		VB
scrape	scrape		VB
scrap	scrap		VB
scratch	scratch		VB
scraunch	scraunch		VB
scrawl	scrawl		VB
screak	screak		VB
scream	scream		VB
screech	screech		VB
screen	screen		VB
screw	screw		VB
scribble	scribble		VB
scribe	scribe		VB
scrimmage	scrimmage		VB
scrimp	scrimp		VB
scrimshank	scrimshank		VB
script	script		VB
scroll	scroll		VB
scrounge	scrounge		VB
scrub	scrub		VB
scrunch	scrunch		VB
scruple	scruple		VB
scrutinise	scrutinise		VB
scrutinize	scrutinize		VB
scry	scry		VB
scud	scud		VB
scuffle	scuffle		VB
scuff	scuff		VB
scull	scull		VB
sculpt	sculpt		VB
sculpture	sculpture		VB
scum	scum		VB
scupper	scupper		VB
scurry	scurry		VB
scuttle	scuttle		VB
scythe	scythe		VB
seal	seal		VB
seam	seam		VB
seaplane	seaplane		VB
search	search		VB
sear	sear		VB
season	season		VB
seat	seat		VB
secede	secede		VB
secernate	secernate		VB
secern	secern		VB
seclude	seclude		VB
second-guess	second-guess		VB
second	second		VB
secrete	secrete		VB
sectionalise	sectionalise		VB
sectionalize	sectionalize		VB
section	section		VB
secularise	secularise		VB
secularize	secularize		VB
secure	secure		VB
sedate	sedate		VB
sediment	sediment		VB
seduce	seduce		VB
seed	seed		VB
seek	seek		VB
seel	seel		VB
seem	seem		VB
seep	seep		VB
seesaw	seesaw		VB
see	see		VB
seethe	seethe		VB
segment	segment		VB
segregate	segregate		VB
segue	segue		VB
seine	seine		VB
seize	seize		VB
select	select		VB
self-destroy	self-destroy		VB
self-destruct	self-destruct		VB
sellotape	sellotape		VB
sell	sell		VB
semaphore	semaphore		VB
semi-automatise	semi-automatise		VB
semi-automatize	semi-automatize		VB
send	send		VB
senesce	senesce		VB
sense	sense		VB
sensibilise	sensibilise		VB
sensibilize	sensibilize		VB
sensify	sensify		VB
sensitise	sensitise		VB
sensitize	sensitize		VB
sensualise	sensualise		VB
sensualize	sensualize		VB
sentence	sentence		VB
sentimentalise	sentimentalise		VB
sentimentalize	sentimentalize		VB
sentimentise	sentimentise		VB
sentimentize	sentimentize		VB
separate	separate		VB
sequence	sequence		VB
sequester	sequester		VB
sequestrate	sequestrate		VB
serenade	serenade		VB
serialise	serialise		VB
serialize	serialize		VB
sermonise	sermonise		VB
sermonize	sermonize		VB
serrate	serrate		VB
serve	serve		VB
service	service		VB
set	set		VB
settle	settle		VB
severalise	severalise		VB
severalize	severalize		VB
sever	sever		VB
sew	sew		VB
sex	sex		VB
sexualise	sexualise		VB
sexualize	sexualize		VB
shackle	shackle		VB
shack	shack		VB
shade	shade		VB
shadowbox	shadowbox		VB
shadow	shadow		VB
shaft	shaft		VB
shag	shag		VB
shake	shake		VB
shallow	shallow		VB
shamanise	shamanise		VB
shamanize	shamanize		VB
shamble	shamble		VB
shame	shame		VB
shampoo	shampoo		VB
sham	sham		VB
shanghai	shanghai		VB
shank	shank		VB
shape	shape		VB
share	share		VB
shark	shark		VB
sharpen	sharpen		VB
sharpshoot	sharpshoot		VB
shatter	shatter		VB
shave	shave		VB
shear	shear		VB
sheathe	sheathe		VB
she-bop	she-bop		VB
shed	shed		VB
sheer	sheer		VB
sheet	sheet		VB
shellack	shellack		VB
shellac	shellac		VB
shell	shell		VB
shelter	shelter		VB
shelve	shelve		VB
shepherd	shepherd		VB
shew	shew		VB
shield	shield		VB
shift	shift		VB
shill	shill		VB
shillyshally	shillyshally		VB
shimmer	shimmer		VB
shimmy	shimmy		VB
shine	shine		VB
shingle	shingle		VB
shinny	shinny		VB
shin	shin		VB
ship	ship		VB
shipwreck	shipwreck		VB
shirk	shirk		VB
shirr	shirr		VB
shirt	shirt		VB
shit	shit		VB
shiver	shiver		VB
shlep	shlep		VB
shmoose	shmoose		VB
shmooze	shmooze		VB
shnorr	shnorr		VB
shoal	shoal		VB
shock	shock		VB
shoehorn	shoehorn		VB
shoe	shoe		VB
shoetree	shoetree		VB
shoo	shoo		VB
shoot	shoot		VB
shoplift	shoplift		VB
shop	shop		VB
shore	shore		VB
short-change	short-change		VB
short-circuit	short-circuit		VB
shorten	shorten		VB
shortlist	shortlist		VB
short	short		VB
shoulder	shoulder		VB
shout	shout		VB
shovel	shovel		VB
shove	shove		VB
shower	shower		VB
show	show		VB
shred	shred		VB
shriek	shriek		VB
shrill	shrill		VB
shrimp	shrimp		VB
shrine	shrine		VB
shrink	shrink		VB
shrinkwrap	shrinkwrap		VB
shrivel	shrivel		VB
shrive	shrive		VB
shroud	shroud		VB
shrug	shrug		VB
shuck	shuck		VB
shudder	shudder		VB
shuffle	shuffle		VB
shun	shun		VB
shunt	shunt		VB
shush	shush		VB
shut	shut		VB
shutter	shutter		VB
shuttlecock	shuttlecock		VB
shuttle	shuttle		VB
shy	shy		VB
sibilate	sibilate		VB
sicken	sicken		VB
sick	sick		VB
sic	sic		VB
sideline	sideline		VB
side	side		VB
side-slip	side-slip		VB
sidestep	sidestep		VB
sideswipe	sideswipe		VB
sidetrack	sidetrack		VB
sidle	sidle		VB
sieve	sieve		VB
sift	sift		VB
sigh	sigh		VB
sight-read	sight-read		VB
sightread	sightread		VB
sightsee	sightsee		VB
sight	sight		VB
sight-sing	sight-sing		VB
sightsing	sightsing		VB
signalise	signalise		VB
signalize	signalize		VB
signal	signal		VB
signify	signify		VB
signpost	signpost		VB
sign	sign		VB
silence	silence		VB
silhouette	silhouette		VB
silkscreen	silkscreen		VB
silt	silt		VB
silver-plate	silver-plate		VB
silverplate	silverplate		VB
silver	silver		VB
simmer	simmer		VB
Simonise	Simonise		VB
Simonize	Simonize		VB
simper	simper		VB
simplify	simplify		VB
simulate	simulate		VB
singe	singe		VB
single-foot	single-foot		VB
single	single		VB
sing	sing		VB
singsong	singsong		VB
singularise	singularise		VB
singularize	singularize		VB
sink	sink		VB
sin	sin		VB
sinter	sinter		VB
siphon	siphon		VB
sip	sip		VB
sire	sire		VB
siss	siss		VB
site	site		VB
sit	sit		VB
situate	situate		VB
size	size		VB
sizzle	sizzle		VB
sizz	sizz		VB
skank	skank		VB
skateboard	skateboard		VB
skate	skate		VB
skedaddle	skedaddle		VB
sketch	sketch		VB
skewer	skewer		VB
skew	skew		VB
skid	skid		VB
skimcoat	skimcoat		VB
skimp	skimp		VB
skim	skim		VB
skin-dive	skin-dive		VB
skinny-dip	skinny-dip		VB
skin	skin		VB
skip-bomb	skip-bomb		VB
skipper	skipper		VB
skip	skip		VB
skirl	skirl		VB
skirmish	skirmish		VB
skirt	skirt		VB
ski	ski		VB
skitter	skitter		VB
skittle	skittle		VB
skive	skive		VB
skreak	skreak		VB
skreigh	skreigh		VB
skulk	skulk		VB
skunk	skunk		VB
skydive	skydive		VB
skyjack	skyjack		VB
skylark	skylark		VB
skyrocket	skyrocket		VB
sky	sky		VB
slabber	slabber		VB
slacken	slacken		VB
slack	slack		VB
slag	slag		VB
slake	slake		VB
slalom	slalom		VB
slam-dunk	slam-dunk		VB
slam	slam		VB
slander	slander		VB
slang	slang		VB
slant	slant		VB
slap	slap		VB
slash	slash		VB
slate	slate		VB
slather	slather		VB
slat	slat		VB
slaughter	slaughter		VB
slaver	slaver		VB
slave	slave		VB
slay	slay		VB
sledgehammer	sledgehammer		VB
sledge	sledge		VB
sled	sled		VB
sleek	sleek		VB
sleep	sleep		VB
sleepwalk	sleepwalk		VB
sleet	sleet		VB
sleigh	sleigh		VB
slenderise	slenderise		VB
slenderize	slenderize		VB
sleuth	sleuth		VB
slew	slew		VB
slice	slice		VB
slick	slick		VB
slide	slide		VB
slight	slight		VB
slime	slime		VB
slim	slim		VB
sling	sling		VB
slink	slink		VB
slip	slip		VB
slither	slither		VB
slit	slit		VB
sliver	sliver		VB
slobber	slobber		VB
sloganeer	sloganeer		VB
slog	slog		VB
slope	slope		VB
slop	slop		VB
slosh	slosh		VB
slot	slot		VB
slouch	slouch		VB
slough	slough		VB
slow	slow		VB
slue	slue		VB
slug	slug		VB
sluice	sluice		VB
slumber	slumber		VB
slump	slump		VB
slum	slum		VB
slurp	slurp		VB
slur	slur		VB
slush	slush		VB
smack	smack		VB
smart	smart		VB
smash	smash		VB
smatter	smatter		VB
smear	smear		VB
smell	smell		VB
smelt	smelt		VB
smile	smile		VB
smirch	smirch		VB
smirk	smirk		VB
smite	smite		VB
smock	smock		VB
smoke	smoke		VB
smolder	smolder		VB
smooch	smooch		VB
smoothen	smoothen		VB
smooth	smooth		VB
smother	smother		VB
smoulder	smoulder		VB
smudge	smudge		VB
smuggle	smuggle		VB
smutch	smutch		VB
smut	smut		VB
snack	snack		VB
snaffle	snaffle		VB
snafu	snafu		VB
snag	snag		VB
snail	snail		VB
snake	snake		VB
snap	snap		VB
snare	snare		VB
snarf	snarf		VB
snarl	snarl		VB
snatch	snatch		VB
sneak	sneak		VB
sneer	sneer		VB
sneeze	sneeze		VB
snicker	snicker		VB
snick	snick		VB
sniffle	sniffle		VB
sniff	sniff		VB
snigger	snigger		VB
snipe	snipe		VB
snip	snip		VB
snitch	snitch		VB
snivel	snivel		VB
snog	snog		VB
snooker	snooker		VB
snoop	snoop		VB
snooze	snooze		VB
snore	snore		VB
snorkel	snorkel		VB
snort	snort		VB
snowball	snowball		VB
snow-blind	snow-blind		VB
snowboard	snowboard		VB
snowmobile	snowmobile		VB
snowshoe	snowshoe		VB
snow	snow		VB
snub	snub		VB
snuffle	snuffle		VB
snuff	snuff		VB
snuggle	snuggle		VB
soak	soak		VB
soap	soap		VB
soar	soar		VB
sober	sober		VB
sob	sob		VB
socialise	socialise		VB
socialize	socialize		VB
sock	sock		VB
sodomise	sodomise		VB
sodomize	sodomize		VB
sod	sod		VB
soften	soften		VB
soft-pedal	soft-pedal		VB
soft-soap	soft-soap		VB
soft-solder	soft-solder		VB
soil	soil		VB
sojourn	sojourn		VB
solace	solace		VB
solarise	solarise		VB
solarize	solarize		VB
solder	solder		VB
soldier	soldier		VB
solemnise	solemnise		VB
solemnize	solemnize		VB
sole	sole		VB
solicit	solicit		VB
solidify	solidify		VB
soliloquise	soliloquise		VB
soliloquize	soliloquize		VB
solmizate	solmizate		VB
solo	solo		VB
solvate	solvate		VB
solve	solve		VB
somersault	somersault		VB
somnambulate	somnambulate		VB
sonnet	sonnet		VB
soothe	soothe		VB
soot	soot		VB
sophisticate	sophisticate		VB
sop	sop		VB
sorb	sorb		VB
sorcerise	sorcerise		VB
sorcerize	sorcerize		VB
sorrow	sorrow		VB
sort	sort		VB
sough	sough		VB
soundproof	soundproof		VB
sound	sound		VB
soup	soup		VB
source	source		VB
sour	sour		VB
souse	souse		VB
sovietise	sovietise		VB
sovietize	sovietize		VB
sow	sow		VB
space	space		VB
spacewalk	spacewalk		VB
spade	spade		VB
spam	spam		VB
spangle	spangle		VB
spang	spang		VB
spank	spank		VB
span	span		VB
spare	spare		VB
sparge	sparge		VB
sparkle	sparkle		VB
spark	spark		VB
spar	spar		VB
spatchcock	spatchcock		VB
spat	spat		VB
spatter	spatter		VB
spawn	spawn		VB
spay	spay		VB
speak	speak		VB
spearhead	spearhead		VB
spear	spear		VB
specialise	specialise		VB
specialize	specialize		VB
speciate	speciate		VB
specify	specify		VB
speckle	speckle		VB
speck	speck		VB
spectate	spectate		VB
speculate	speculate		VB
speechify	speechify		VB
speech-read	speech-read		VB
speed	speed		VB
spellbind	spellbind		VB
spell	spell		VB
spelunk	spelunk		VB
spend	spend		VB
spew	spew		VB
sphacelate	sphacelate		VB
spice	spice		VB
spiel	spiel		VB
spike	spike		VB
spill	spill		VB
spin-dry	spin-dry		VB
spin	spin		VB
spiral	spiral		VB
spiritise	spiritise		VB
spiritize	spiritize		VB
spirit	spirit		VB
spiritualise	spiritualise		VB
spiritualize	spiritualize		VB
spirt	spirt		VB
spite	spite		VB
spit	spit		VB
splash	splash		VB
splat	splat		VB
splatter	splatter		VB
splay	splay		VB
splice	splice		VB
splinter	splinter		VB
splint	splint		VB
split	split		VB
splosh	splosh		VB
splotch	splotch		VB
splurge	splurge		VB
splutter	splutter		VB
spoil	spoil		VB
spondaise	spondaise		VB
spondaize	spondaize		VB
sponge	sponge		VB
sponsor	sponsor		VB
spoof	spoof		VB
spook	spook		VB
spool	spool		VB
spoonfeed	spoonfeed		VB
spoon	spoon		VB
sportscast	sportscast		VB
sport	sport		VB
sporulate	sporulate		VB
spot-check	spot-check		VB
spotlight	spotlight		VB
spot	spot		VB
spot-weld	spot-weld		VB
spotweld	spotweld		VB
spout	spout		VB
sprain	sprain		VB
sprawl	sprawl		VB
spray-dry	spray-dry		VB
spray	spray		VB
spread-eagle	spread-eagle		VB
spreadeagle	spreadeagle		VB
spread	spread		VB
spree	spree		VB
spring-clean	spring-clean		VB
spring	spring		VB
sprinkle	sprinkle		VB
sprint	sprint		VB
spritz	spritz		VB
sprout	sprout		VB
spruce	spruce		VB
spud	spud		VB
spue	spue		VB
spume	spume		VB
spurn	spurn		VB
spur	spur		VB
spurt	spurt		VB
sputter	sputter		VB
spy	spy		VB
squabble	squabble		VB
squall	squall		VB
squander	squander		VB
square	square		VB
squash	squash		VB
squat	squat		VB
squawk	squawk		VB
squeak	squeak		VB
squeal	squeal		VB
squeegee	squeegee		VB
squeeze	squeeze		VB
squelch	squelch		VB
squinch	squinch		VB
squint	squint		VB
squire	squire		VB
squirm	squirm		VB
squirt	squirt		VB
squish	squish		VB
stabilise	stabilise		VB
stabilize	stabilize		VB
stable	stable		VB
stab	stab		VB
stack	stack		VB
staff	staff		VB
stage	stage		VB
stagger	stagger		VB
stagnate	stagnate		VB
stag	stag		VB
stain	stain		VB
stake	stake		VB
stalemate	stalemate		VB
stale	stale		VB
stalinise	stalinise		VB
stalinize	stalinize		VB
stalk	stalk		VB
stall	stall		VB
stammer	stammer		VB
stampede	stampede		VB
stamp	stamp		VB
stanch	stanch		VB
standardise	standardise		VB
standardize	standardize		VB
stand	stand		VB
staple	staple		VB
starboard	starboard		VB
starch	starch		VB
stare	stare		VB
stargaze	stargaze		VB
star	star		VB
startle	startle		VB
start	start		VB
starve	starve		VB
stash	stash		VB
state	state		VB
station	station		VB
staunch	staunch		VB
stave	stave		VB
stay	stay		VB
steady	steady		VB
steal	steal		VB
steamer	steamer		VB
steam-heat	steam-heat		VB
steamroller	steamroller		VB
steamroll	steamroll		VB
steam	steam		VB
steel	steel		VB
steepen	steepen		VB
steep	steep		VB
steer	steer		VB
stem	stem		VB
stencil	stencil		VB
stenograph	stenograph		VB
step	step		VB
stereotype	stereotype		VB
sterilise	sterilise		VB
sterilize	sterilize		VB
stet	stet		VB
stew	stew		VB
stickle	stickle		VB
stick	stick		VB
stiffen	stiffen		VB
stifle	stifle		VB
stigmatise	stigmatise		VB
stigmatize	stigmatize		VB
still-fish	still-fish		VB
still-hunt	still-hunt		VB
still	still		VB
stimulate	stimulate		VB
sting	sting		VB
stink	stink		VB
stint	stint		VB
stipple	stipple		VB
stipulate	stipulate		VB
stir	stir		VB
stitch	stitch		VB
stockade	stockade		VB
stockpile	stockpile		VB
stock	stock		VB
stock-take	stock-take		VB
stoke	stoke		VB
stomach	stomach		VB
stomp	stomp		VB
stone	stone		VB
stonewall	stonewall		VB
stone-wash	stone-wash		VB
stonewash	stonewash		VB
stooge	stooge		VB
stool	stool		VB
stoop	stoop		VB
stopper	stopper		VB
stopple	stopple		VB
stop	stop		VB
store	store		VB
storm	storm		VB
stow	stow		VB
straddle	straddle		VB
strafe	strafe		VB
straggle	straggle		VB
straighten	straighten		VB
strain	strain		VB
straiten	straiten		VB
strand	strand		VB
strangle	strangle		VB
strangulate	strangulate		VB
strap	strap		VB
stratify	stratify		VB
straw	straw		VB
stray	stray		VB
streak	streak		VB
streamline	streamline		VB
stream	stream		VB
street-walk	street-walk		VB
streetwalk	streetwalk		VB
strengthen	strengthen		VB
stress	stress		VB
stretch	stretch		VB
strew	strew		VB
striate	striate		VB
strickle	strickle		VB
stride	stride		VB
stridulate	stridulate		VB
strike	strike		VB
string	string		VB
stripe	stripe		VB
strip-search	strip-search		VB
strip	strip		VB
strive	strive		VB
stroke	stroke		VB
stroll	stroll		VB
strong-arm	strong-arm		VB
strop	strop		VB
structure	structure		VB
struggle	struggle		VB
strum	strum		VB
strut	strut		VB
stub	stub		VB
stucco	stucco		VB
stud	stud		VB
study	study		VB
stuff	stuff		VB
stultify	stultify		VB
stumble	stumble		VB
stump	stump		VB
stun	stun		VB
stunt	stunt		VB
stupefy	stupefy		VB
stutter	stutter		VB
style	style		VB
stylise	stylise		VB
stylize	stylize		VB
stymie	stymie		VB
stymy	stymy		VB
subcontract	subcontract		VB
subdivide	subdivide		VB
subdue	subdue		VB
subedit	subedit		VB
subject	subject		VB
subjoin	subjoin		VB
subjugate	subjugate		VB
sublease	sublease		VB
sublet	sublet		VB
sublimate	sublimate		VB
sublime	sublime		VB
subluxate	subluxate		VB
submarine	submarine		VB
submerge	submerge		VB
submerse	submerse		VB
submit	submit		VB
subordinate	subordinate		VB
suborn	suborn		VB
subpoena	subpoena		VB
subrogate	subrogate		VB
subscribe	subscribe		VB
subserve	subserve		VB
subside	subside		VB
subsidise	subsidise		VB
subsidize	subsidize		VB
subsist	subsist		VB
substantiate	substantiate		VB
substitute	substitute		VB
sub	sub		VB
subsume	subsume		VB
subtend	subtend		VB
subtilise	subtilise		VB
subtilize	subtilize		VB
subtitle	subtitle		VB
subtract	subtract		VB
suburbanise	suburbanise		VB
suburbanize	suburbanize		VB
subvention	subvention		VB
subvent	subvent		VB
subvert	subvert		VB
subvocalise	subvocalise		VB
subvocalize	subvocalize		VB
succeed	succeed		VB
succor	succor		VB
succour	succour		VB
succumb	succumb		VB
succuss	succuss		VB
suckle	suckle		VB
suck	suck		VB
suction	suction		VB
sudate	sudate		VB
suds	suds		VB
sue	sue		VB
suffer	suffer		VB
suffice	suffice		VB
suffix	suffix		VB
suffocate	suffocate		VB
suffuse	suffuse		VB
sugarcoat	sugarcoat		VB
sugar	sugar		VB
suggest	suggest		VB
suit	suit		VB
sulfate	sulfate		VB
sulfurette	sulfurette		VB
sulfur	sulfur		VB
sulk	sulk		VB
sully	sully		VB
sulphurette	sulphurette		VB
sulphur	sulphur		VB
summarise	summarise		VB
summarize	summarize		VB
summate	summate		VB
summerise	summerise		VB
summerize	summerize		VB
summer	summer		VB
summit	summit		VB
summons	summons		VB
summon	summon		VB
sum	sum		VB
sunbathe	sunbathe		VB
sunburn	sunburn		VB
sunder	sunder		VB
sun	sun		VB
suntan	suntan		VB
superannuate	superannuate		VB
supercede	supercede		VB
supercharge	supercharge		VB
superfetate	superfetate		VB
superimpose	superimpose		VB
superinfect	superinfect		VB
superintend	superintend		VB
superordinate	superordinate		VB
superpose	superpose		VB
superscribe	superscribe		VB
supersede	supersede		VB
supervene	supervene		VB
supervise	supervise		VB
supinate	supinate		VB
supplant	supplant		VB
supplement	supplement		VB
supple	supple		VB
supplicate	supplicate		VB
supply	supply		VB
support	support		VB
suppose	suppose		VB
suppress	suppress		VB
suppurate	suppurate		VB
sup	sup		VB
surcharge	surcharge		VB
surface-mine	surface-mine		VB
surface	surface		VB
surfboard	surfboard		VB
surfeit	surfeit		VB
surf	surf		VB
surge	surge		VB
surmise	surmise		VB
surmount	surmount		VB
surpass	surpass		VB
surprise	surprise		VB
surrender	surrender		VB
surround	surround		VB
surtax	surtax		VB
surveil	surveil		VB
survey	survey		VB
survive	survive		VB
suspect	suspect		VB
suspend	suspend		VB
suspire	suspire		VB
sustain	sustain		VB
susurrate	susurrate		VB
suture	suture		VB
swab	swab		VB
swaddle	swaddle		VB
swage	swage		VB
swagger	swagger		VB
swag	swag		VB
swallow	swallow		VB
swamp	swamp		VB
swank	swank		VB
swan	swan		VB
swap	swap		VB
swarm	swarm		VB
swash	swash		VB
swathe	swathe		VB
swat	swat		VB
swatter	swatter		VB
sway	sway		VB
swear	swear		VB
sweat	sweat		VB
sweep	sweep		VB
sweeten	sweeten		VB
sweet-talk	sweet-talk		VB
swell	swell		VB
swelter	swelter		VB
swerve	swerve		VB
swig	swig		VB
swill	swill		VB
swim	swim		VB
swindle	swindle		VB
swinge	swinge		VB
swing	swing		VB
swipe	swipe		VB
swirl	swirl		VB
swish	swish		VB
switch-hit	switch-hit		VB
switch	switch		VB
swivel	swivel		VB
swob	swob		VB
swoon	swoon		VB
swoop	swoop		VB
swoosh	swoosh		VB
swop	swop		VB
swosh	swosh		VB
swot	swot		VB
syllabicate	syllabicate		VB
syllabify	syllabify		VB
syllabise	syllabise		VB
syllabize	syllabize		VB
syllogise	syllogise		VB
syllogize	syllogize		VB
symbolise	symbolise		VB
symbolize	symbolize		VB
symmetrise	symmetrise		VB
symmetrize	symmetrize		VB
sympathise	sympathise		VB
sympathize	sympathize		VB
symphonise	symphonise		VB
symphonize	symphonize		VB
synchronise	synchronise		VB
synchronize	synchronize		VB
syncopate	syncopate		VB
syncretise	syncretise		VB
syncretize	syncretize		VB
sync	sync		VB
syndicate	syndicate		VB
synthesise	synthesise		VB
synthesize	synthesize		VB
syphon	syphon		VB
syringe	syringe		VB
systematise	systematise		VB
systematize	systematize		VB
systemise	systemise		VB
systemize	systemize		VB
table	table		VB
taboo	taboo		VB
tabularise	tabularise		VB
tabularize	tabularize		VB
tabulate	tabulate		VB
tackle	tackle		VB
tack	tack		VB
tag	tag		VB
tailgate	tailgate		VB
tailor-make	tailor-make		VB
tailor	tailor		VB
tail	tail		VB
taint	taint		VB
take	take		VB
talc	talc		VB
talk	talk		VB
tally	tally		VB
tame	tame		VB
tamper	tamper		VB
tampon	tampon		VB
tamp	tamp		VB
tangle	tangle		VB
tango	tango		VB
tank	tank		VB
tantalise	tantalise		VB
tantalize	tantalize		VB
tan	tan		VB
tapdance	tapdance		VB
taper	taper		VB
tape	tape		VB
tap	tap		VB
tar-and-feather	tar-and-feather		VB
target	target		VB
tariff	tariff		VB
tarmac	tarmac		VB
tarnish	tarnish		VB
tarry	tarry		VB
tar	tar		VB
task	task		VB
taste	taste		VB
tat	tat		VB
tattle	tattle		VB
tattoo	tattoo		VB
taunt	taunt		VB
tauten	tauten		VB
taxi	taxi		VB
tax	tax		VB
teach	teach		VB
team	team		VB
teargas	teargas		VB
tear	tear		VB
tease	tease		VB
teem	teem		VB
tee	tee		VB
teeter	teeter		VB
teeter-totter	teeter-totter		VB
teetertotter	teetertotter		VB
teethe	teethe		VB
teetotal	teetotal		VB
telecast	telecast		VB
telecommunicate	telecommunicate		VB
telefax	telefax		VB
telegraph	telegraph		VB
telepathise	telepathise		VB
telepathize	telepathize		VB
telephone	telephone		VB
teleport	teleport		VB
telescope	telescope		VB
televise	televise		VB
telex	telex		VB
tell	tell		VB
temper	temper		VB
temporise	temporise		VB
temporize	temporize		VB
tempt	tempt		VB
tenant	tenant		VB
tenderise	tenderise		VB
tenderize	tenderize		VB
tender	tender		VB
tend	tend		VB
tense	tense		VB
tent	tent		VB
tenure	tenure		VB
tergiversate	tergiversate		VB
terminate	terminate		VB
term	term		VB
terrace	terrace		VB
terrasse	terrasse		VB
terrify	terrify		VB
territorialise	territorialise		VB
territorialize	territorialize		VB
terrorise	terrorise		VB
terrorize	terrorize		VB
tessellate	tessellate		VB
testify	testify		VB
test	test		VB
tether	tether		VB
thank	thank		VB
thatch	thatch		VB
thaw	thaw		VB
theme	theme		VB
theologise	theologise		VB
theologize	theologize		VB
theorise	theorise		VB
theorize	theorize		VB
thermostat	thermostat		VB
thicken	thicken		VB
thieve	thieve		VB
think	think		VB
thin	thin		VB
thirst	thirst		VB
thoriate	thoriate		VB
thrash	thrash		VB
thread	thread		VB
threaten	threaten		VB
thresh	thresh		VB
thrill	thrill		VB
thrive	thrive		VB
throb	throb		VB
thrombose	thrombose		VB
throne	throne		VB
throng	throng		VB
throttle	throttle		VB
throw	throw		VB
thrum	thrum		VB
thrust	thrust		VB
thud	thud		VB
thumbtack	thumbtack		VB
thumb	thumb		VB
thump	thump		VB
thunder	thunder		VB
thurify	thurify		VB
thwack	thwack		VB
thwart	thwart		VB
ticket	ticket		VB
tickle	tickle		VB
ticktack	ticktack		VB
tick	tick		VB
ticktock	ticktock		VB
tide	tide		VB
tidy	tidy		VB
tie-dye	tie-dye		VB
tie	tie		VB
tighten	tighten		VB
tile	tile		VB
tiller	tiller		VB
till	till		VB
tilt	tilt		VB
time	time		VB
tinct	tinct		VB
tincture	tincture		VB
tinge	tinge		VB
tingle	tingle		VB
ting	ting		VB
tinker	tinker		VB
tinkle	tinkle		VB
tink	tink		VB
tinsel	tinsel		VB
tintinnabulate	tintinnabulate		VB
tin	tin		VB
tint	tint		VB
tipple	tipple		VB
tippytoe	tippytoe		VB
tip	tip		VB
tiptoe	tiptoe		VB
tire	tire		VB
tissue	tissue		VB
tithe	tithe		VB
titillate	titillate		VB
titivate	titivate		VB
title	title		VB
titrate	titrate		VB
titter	titter		VB
tittivate	tittivate		VB
tittle-tattle	tittle-tattle		VB
tittup	tittup		VB
toady	toady		VB
toast	toast		VB
toboggan	toboggan		VB
toddle	toddle		VB
toenail	toenail		VB
toe	toe		VB
toggle	toggle		VB
tog	tog		VB
toilet-train	toilet-train		VB
toil	toil		VB
tolerate	tolerate		VB
toll	toll		VB
tomahawk	tomahawk		VB
tone	tone		VB
tongue-tie	tongue-tie		VB
tongue	tongue		VB
tonsure	tonsure		VB
tool	tool		VB
tootle	tootle		VB
toot	toot		VB
topdress	topdress		VB
tope	tope		VB
topicalize	topicalize		VB
topple	topple		VB
top	top		VB
torch	torch		VB
torment	torment		VB
torpedo	torpedo		VB
torture	torture		VB
toss	toss		VB
totalise	totalise		VB
totalize	totalize		VB
total	total		VB
tote	tote		VB
totter	totter		VB
tot	tot		VB
touch	touch		VB
touch-type	touch-type		VB
toughen	toughen		VB
tourney	tourney		VB
tour	tour		VB
tousle	tousle		VB
tout	tout		VB
towel	towel		VB
tower	tower		VB
tow	tow		VB
toy	toy		VB
trace	trace		VB
track	track		VB
trademark	trademark		VB
trade	trade		VB
traduce	traduce		VB
traffic	traffic		VB
trail	trail		VB
train	train		VB
traipse	traipse		VB
trammel	trammel		VB
trample	trample		VB
tramp	tramp		VB
tram	tram		VB
trance	trance		VB
tranquilize	tranquilize		VB
tranquillise	tranquillise		VB
tranquillize	tranquillize		VB
transact	transact		VB
transaminate	transaminate		VB
transcend	transcend		VB
transcribe	transcribe		VB
transduce	transduce		VB
transect	transect		VB
transfer	transfer		VB
transfigure	transfigure		VB
transfix	transfix		VB
transform	transform		VB
transfuse	transfuse		VB
transgress	transgress		VB
transistorise	transistorise		VB
transistorize	transistorize		VB
transition	transition		VB
transitivise	transitivise		VB
transitivize	transitivize		VB
transit	transit		VB
translate	translate		VB
transliterate	transliterate		VB
translocate	translocate		VB
transmigrate	transmigrate		VB
transmit	transmit		VB
transmogrify	transmogrify		VB
transmute	transmute		VB
transpirate	transpirate		VB
transpire	transpire		VB
transplant	transplant		VB
transport	transport		VB
transpose	transpose		VB
transship	transship		VB
transubstantiate	transubstantiate		VB
transude	transude		VB
trap	trap		VB
trash	trash		VB
traumatise	traumatise		VB
traumatize	traumatize		VB
travail	travail		VB
travel	travel		VB
traverse	traverse		VB
travesty	travesty		VB
trawl	trawl		VB
treadle	treadle		VB
tread	tread		VB
treasure	treasure		VB
treat	treat		VB
treble	treble		VB
tree	tree		VB
trek	trek		VB
trellis	trellis		VB
tremble	tremble		VB
tremor	tremor		VB
trench	trench		VB
trend	trend		VB
trepan	trepan		VB
trephine	trephine		VB
trespass	trespass		VB
triangulate	triangulate		VB
tribulate	tribulate		VB
trice	trice		VB
trickle	trickle		VB
trick	trick		VB
trifle	trifle		VB
trifurcate	trifurcate		VB
trigger	trigger		VB
trill	trill		VB
trim	trim		VB
triple-space	triple-space		VB
triple-tongue	triple-tongue		VB
triple	triple		VB
triplicate	triplicate		VB
trip	trip		VB
trisect	trisect		VB
triumph	triumph		VB
trivialise	trivialise		VB
trivialize	trivialize		VB
troat	troat		VB
troll	troll		VB
troop	troop		VB
trot	trot		VB
trouble-shoot	trouble-shoot		VB
troubleshoot	troubleshoot		VB
trouble	trouble		VB
trounce	trounce		VB
trowel	trowel		VB
truckle	truckle		VB
truck	truck		VB
trudge	trudge		VB
true	true		VB
trumpet	trumpet		VB
trump	trump		VB
truncate	truncate		VB
trundle	trundle		VB
truss	truss		VB
trust	trust		VB
try	try		VB
tsk	tsk		VB
tube	tube		VB
tucker	tucker		VB
tuck	tuck		VB
tug	tug		VB
tumble	tumble		VB
tumefy	tumefy		VB
tumesce	tumesce		VB
tune	tune		VB
tunnel	tunnel		VB
turf	turf		VB
turn	turn		VB
turtle	turtle		VB
tusk	tusk		VB
tussle	tussle		VB
tutor	tutor		VB
tut-tut	tut-tut		VB
tut	tut		VB
twaddle	twaddle		VB
twang	twang		VB
tweak	tweak		VB
tweedle	tweedle		VB
tweet	tweet		VB
tweeze	tweeze		VB
twiddle	twiddle		VB
twig	twig		VB
twill	twill		VB
twine	twine		VB
twinge	twinge		VB
twinkle	twinkle		VB
twin	twin		VB
twirl	twirl		VB
twirp	twirp		VB
twist	twist		VB
twitch	twitch		VB
twitter	twitter		VB
twit	twit		VB
two-step	two-step		VB
two-time	two-time		VB
typecast	typecast		VB
typeset	typeset		VB
type	type		VB
typewrite	typewrite		VB
typify	typify		VB
tyrannise	tyrannise		VB
tyrannize	tyrannize		VB
uglify	uglify		VB
ulcerate	ulcerate		VB
ultracentrifuge	ultracentrifuge		VB
ululate	ululate		VB
umpire	umpire		VB
unarm	unarm		VB
unbalance	unbalance		VB
unbar	unbar		VB
unbelt	unbelt		VB
unbend	unbend		VB
unbind	unbind		VB
unblock	unblock		VB
unbolt	unbolt		VB
unbosom	unbosom		VB
unbox	unbox		VB
unbrace	unbrace		VB
unbraid	unbraid		VB
unbridle	unbridle		VB
unbuckle	unbuckle		VB
unburden	unburden		VB
unbutton	unbutton		VB
uncase	uncase		VB
unchain	unchain		VB
unchurch	unchurch		VB
unclasp	unclasp		VB
unclip	unclip		VB
uncloak	uncloak		VB
unclog	unclog		VB
unclothe	unclothe		VB
unclutter	unclutter		VB
uncoil	uncoil		VB
uncompress	uncompress		VB
uncork	uncork		VB
uncouple	uncouple		VB
uncover	uncover		VB
uncrate	uncrate		VB
uncross	uncross		VB
uncurl	uncurl		VB
undeceive	undeceive		VB
underachieve	underachieve		VB
underact	underact		VB
underbid	underbid		VB
undercharge	undercharge		VB
undercoat	undercoat		VB
undercut	undercut		VB
underdevelop	underdevelop		VB
underdress	underdress		VB
underestimate	underestimate		VB
underexpose	underexpose		VB
undergird	undergird		VB
undergo	undergo		VB
undergrow	undergrow		VB
underlay	underlay		VB
underlie	underlie		VB
underline	underline		VB
undermine	undermine		VB
undernourish	undernourish		VB
underpay	underpay		VB
underperform	underperform		VB
underpin	underpin		VB
underplay	underplay		VB
underprice	underprice		VB
underproduce	underproduce		VB
underquote	underquote		VB
underrate	underrate		VB
underscore	underscore		VB
undersell	undersell		VB
undershoot	undershoot		VB
undersign	undersign		VB
underspend	underspend		VB
understand	understand		VB
understate	understate		VB
understock	understock		VB
understudy	understudy		VB
undertake	undertake		VB
undervalue	undervalue		VB
underwrite	underwrite		VB
undock	undock		VB
undo	undo		VB
undrape	undrape		VB
undress	undress		VB
undulate	undulate		VB
unearth	unearth		VB
unfasten	unfasten		VB
unfit	unfit		VB
unfold	unfold		VB
unfreeze	unfreeze		VB
unfrock	unfrock		VB
unfurl	unfurl		VB
unhallow	unhallow		VB
unhand	unhand		VB
unharness	unharness		VB
unhinge	unhinge		VB
unhitch	unhitch		VB
unhook	unhook		VB
unhorse	unhorse		VB
unicycle	unicycle		VB
uniformise	uniformise		VB
uniformize	uniformize		VB
uniform	uniform		VB
unify	unify		VB
unionise	unionise		VB
unionize	unionize		VB
unite	unite		VB
unitise	unitise		VB
unitize	unitize		VB
universalise	universalise		VB
universalize	universalize		VB
unknot	unknot		VB
unlace	unlace		VB
unlade	unlade		VB
unlash	unlash		VB
unlax	unlax		VB
unlearn	unlearn		VB
unleash	unleash		VB
unlive	unlive		VB
unload	unload		VB
unlock	unlock		VB
unloosen	unloosen		VB
unloose	unloose		VB
unmake	unmake		VB
unman	unman		VB
unmask	unmask		VB
unmuzzle	unmuzzle		VB
unnerve	unnerve		VB
unpack	unpack		VB
unpick	unpick		VB
unpin	unpin		VB
unplug	unplug		VB
unravel	unravel		VB
unreel	unreel		VB
unroll	unroll		VB
unsaddle	unsaddle		VB
unsanctify	unsanctify		VB
unsay	unsay		VB
unscramble	unscramble		VB
unscrew	unscrew		VB
unseal	unseal		VB
unseat	unseat		VB
unsettle	unsettle		VB
unsex	unsex		VB
unsheathe	unsheathe		VB
unsnarl	unsnarl		VB
unsolder	unsolder		VB
unspell	unspell		VB
unstaple	unstaple		VB
unstrain	unstrain		VB
unstrap	unstrap		VB
unstring	unstring		VB
unstuff	unstuff		VB
unsubstantialise	unsubstantialise		VB
unsubstantialize	unsubstantialize		VB
untangle	untangle		VB
unteach	unteach		VB
unthaw	unthaw		VB
untie	untie		VB
untune	untune		VB
untwine	untwine		VB
untwist	untwist		VB
unveil	unveil		VB
unweave	unweave		VB
unwind	unwind		VB
unwire	unwire		VB
unwrap	unwrap		VB
unyoke	unyoke		VB
unzip	unzip		VB
upbraid	upbraid		VB
upchuck	upchuck		VB
update	update		VB
upend	upend		VB
upgrade	upgrade		VB
upheave	upheave		VB
uphold	uphold		VB
upholster	upholster		VB
uplift	uplift		VB
upload	upload		VB
upraise	upraise		VB
uprise	uprise		VB
uproot	uproot		VB
upset	upset		VB
upstage	upstage		VB
up	up		VB
urbanise	urbanise		VB
urbanize	urbanize		VB
urge	urge		VB
urinate	urinate		VB
urticate	urticate		VB
use	use		VB
usher	usher		VB
usurp	usurp		VB
utilise	utilise		VB
utilize	utilize		VB
utter	utter		VB
vacate	vacate		VB
vacation	vacation		VB
vaccinate	vaccinate		VB
vacillate	vacillate		VB
vacuum-clean	vacuum-clean		VB
vacuum	vacuum		VB
vagabond	vagabond		VB
valet	valet		VB
validate	validate		VB
valuate	valuate		VB
value	value		VB
vamoose	vamoose		VB
vamp	vamp		VB
vandalise	vandalise		VB
vandalize	vandalize		VB
vanish	vanish		VB
vanquish	vanquish		VB
vaporise	vaporise		VB
vaporize	vaporize		VB
variegate	variegate		VB
varnish	varnish		VB
vary	vary		VB
vascularise	vascularise		VB
vascularize	vascularize		VB
vasectomise	vasectomise		VB
vasectomize	vasectomize		VB
vaticinate	vaticinate		VB
vault	vault		VB
vaunt	vaunt		VB
veer	veer		VB
vegetate	vegetate		VB
veil	veil		VB
vein	vein		VB
velcro	velcro		VB
vellicate	vellicate		VB
vend	vend		VB
veneer	veneer		VB
venerate	venerate		VB
venesect	venesect		VB
ventilate	ventilate		VB
venture	venture		VB
vent	vent		VB
verbalise	verbalise		VB
verbalize	verbalize		VB
verbify	verbify		VB
verdigris	verdigris		VB
verge	verge		VB
verify	verify		VB
vermiculate	vermiculate		VB
vermilion	vermilion		VB
verse	verse		VB
versify	versify		VB
vesicate	vesicate		VB
vesiculate	vesiculate		VB
vesture	vesture		VB
vest	vest		VB
veto	veto		VB
vet	vet		VB
vex	vex		VB
vibrate	vibrate		VB
victimise	victimise		VB
victimize	victimize		VB
victual	victual		VB
videotape	videotape		VB
vie	vie		VB
view	view		VB
vilify	vilify		VB
vilipend	vilipend		VB
vindicate	vindicate		VB
vinify	vinify		VB
violate	violate		VB
virilise	virilise		VB
virilize	virilize		VB
visa	visa		VB
visit	visit		VB
visualise	visualise		VB
visualize	visualize		VB
vitalise	vitalise		VB
vitalize	vitalize		VB
vitaminise	vitaminise		VB
vitaminize	vitaminize		VB
vitiate	vitiate		VB
vitrify	vitrify		VB
vitriol	vitriol		VB
vituperate	vituperate		VB
vivify	vivify		VB
vivisect	vivisect		VB
vocalise	vocalise		VB
vocalize	vocalize		VB
vociferate	vociferate		VB
voice	voice		VB
void	void		VB
volatilise	volatilise		VB
volatilize	volatilize		VB
volley	volley		VB
volunteer	volunteer		VB
vomit	vomit		VB
voodoo	voodoo		VB
vote	vote		VB
vouchsafe	vouchsafe		VB
vouch	vouch		VB
vowelise	vowelise		VB
vowelize	vowelize		VB
vow	vow		VB
voyage	voyage		VB
vroom	vroom		VB
vulcanise	vulcanise		VB
vulcanize	vulcanize		VB
vulgarise	vulgarise		VB
vulgarize	vulgarize		VB
waddle	waddle		VB
wade	wade		VB
wad	wad		VB
waffle	waffle		VB
waft	waft		VB
wager	wager		VB
wage	wage		VB
waggle	waggle		VB
wag	wag		VB
wail	wail		VB
waitress	waitress		VB
wait	wait		VB
waive	waive		VB
waken	waken		VB
wake	wake		VB
walk	walk		VB
wallop	wallop		VB
wallow	wallow		VB
wallpaper	wallpaper		VB
wall	wall		VB
waltz	waltz		VB
wamble	wamble		VB
wander	wander		VB
wane	wane		VB
wangle	wangle		VB
wank	wank		VB
wanton	wanton		VB
want	want		VB
wan	wan		VB
warble	warble		VB
ward	ward		VB
warehouse	warehouse		VB
ware	ware		VB
warm	warm		VB
warn	warn		VB
warp	warp		VB
warrant	warrant		VB
war	war		VB
wash	wash		VB
wassail	wassail		VB
waste	waste		VB
watch	watch		VB
watercolor	watercolor		VB
watercolour	watercolour		VB
waterproof	waterproof		VB
water-wash	water-wash		VB
water	water		VB
wattle	wattle		VB
waul	waul		VB
waver	waver		VB
wave	wave		VB
wawl	wawl		VB
wax	wax		VB
waylay	waylay		VB
weaken	weaken		VB
wean	wean		VB
weaponize	weaponize		VB
wear	wear		VB
weary	weary		VB
weatherproof	weatherproof		VB
weatherstrip	weatherstrip		VB
weather	weather		VB
weave	weave		VB
web	web		VB
wedel	wedel		VB
wedge	wedge		VB
wed	wed		VB
weed	weed		VB
weekend	weekend		VB
weep	weep		VB
wee	wee		VB
wee-wee	wee-wee		VB
weight-lift	weight-lift		VB
weightlift	weightlift		VB
weight	weight		VB
weigh	weigh		VB
welch	welch		VB
welcome	welcome		VB
weld	weld		VB
well	well		VB
welsh	welsh		VB
welter	welter		VB
welt	welt		VB
wench	wench		VB
wend	wend		VB
westernise	westernise		VB
westernize	westernize		VB
wet-nurse	wet-nurse		VB
wet	wet		VB
whack	whack		VB
whale	whale		VB
wham	wham		VB
whang	whang		VB
whap	whap		VB
wharf	wharf		VB
wheedle	wheedle		VB
wheelbarrow	wheelbarrow		VB
wheel	wheel		VB
wheeze	wheeze		VB
whelk	whelk		VB
whelm	whelm		VB
whelp	whelp		VB
whet	whet		VB
whicker	whicker		VB
whiff	whiff		VB
whimper	whimper		VB
whine	whine		VB
whinny	whinny		VB
whipsaw	whipsaw		VB
whip	whip		VB
whirligig	whirligig		VB
whirlpool	whirlpool		VB
whirl	whirl		VB
whirr	whirr		VB
whir	whir		VB
whish	whish		VB
whisker	whisker		VB
whisk	whisk		VB
whisper	whisper		VB
whistlestop	whistlestop		VB
whistle	whistle		VB
whiten	whiten		VB
white-out	white-out		VB
whiteout	whiteout		VB
whitewash	whitewash		VB
white	white		VB
whittle	whittle		VB
whiz	whiz		VB
whizz	whizz		VB
wholesale	wholesale		VB
whomp	whomp		VB
whoop	whoop		VB
whoosh	whoosh		VB
whop	whop		VB
whore	whore		VB
widen	widen		VB
widow	widow		VB
wield	wield		VB
wiggle	wiggle		VB
wigwag	wigwag		VB
will	will		VB
wilt	wilt		VB
wince	wince		VB
winch	winch		VB
window-dress	window-dress		VB
window-shop	window-shop		VB
windsurf	windsurf		VB
wind	wind		VB
wine	wine		VB
wing	wing		VB
winkle	winkle		VB
wink	wink		VB
winnow	winnow		VB
winterise	winterise		VB
winterize	winterize		VB
winter	winter		VB
win	win		VB
wipe	wipe		VB
wiretap	wiretap		VB
wire	wire		VB
wisecrack	wisecrack		VB
wish	wish		VB
witch	witch		VB
withdraw	withdraw		VB
wither	wither		VB
withhold	withhold		VB
withstand	withstand		VB
witness	witness		VB
wive	wive		VB
wobble	wobble		VB
wolf-whistle	wolf-whistle		VB
wolf	wolf		VB
womanise	womanise		VB
womanize	womanize		VB
wonder	wonder		VB
woolgather	woolgather		VB
woosh	woosh		VB
woo	woo		VB
word	word		VB
work	work		VB
worm	worm		VB
worry	worry		VB
worsen	worsen		VB
worship	worship		VB
worst	worst		VB
wound	wound		VB
wow	wow		VB
wrack	wrack		VB
wrangle	wrangle		VB
wrap	wrap		VB
wrawl	wrawl		VB
wreak	wreak		VB
wreathe	wreathe		VB
wreck	wreck		VB
wrench	wrench		VB
wrestle	wrestle		VB
wrest	wrest		VB
wrick	wrick		VB
wriggle	wriggle		VB
wring	wring		VB
wrinkle	wrinkle		VB
write	write		VB
writhe	writhe		VB
wrong	wrong		VB
xerox	xerox		VB
x-ray	x-ray		VB
yacht	yacht		VB
yack	yack		VB
yak	yak		VB
yammer	yammer		VB
yank	yank		VB
yap	yap		VB
yarn-dye	yarn-dye		VB
yarn	yarn		VB
yaup	yaup		VB
yawl	yawl		VB
yawn	yawn		VB
yawp	yawp		VB
yaw	yaw		VB
yearn	yearn		VB
yellow	yellow		VB
yell	yell		VB
yelp	yelp		VB
yen	yen		VB
yield	yield		VB
yip	yip		VB
yodel	yodel		VB
yoke	yoke		VB
yowl	yowl		VB
zap	zap		VB
zero	zero		VB
zest	zest		VB
zigzag	zigzag		VB
zinc	zinc		VB
zipper	zipper		VB
zip	zip		VB
zone	zone		VB
zoom	zoom		VB
