ADJ	ADJ
ADJ-Degree=Cmp	ADJ-Degree=Cmp
ADJ-Degree=Sup	ADJ-Degree=Sup
ADP	ADP
ADV	ADV
ADV-Degree=Cmp	ADV-Degree=Cmp
ADV-Degree=Sup	ADV-Degree=Sup
ADV-PronType=Int	ADV-PronType=Int
AUX-VerbForm=Fin	AUX-VerbForm=Fin
CCONJ	CCONJ
DET	DET
INTJ	INTJ
NOUN	NOUN
NOUN-Number=Sing	NOUN-Number=Sing
NOUN-Number=Plur	NOUN-Number=Plur
NUM-NumType=Card	NUM-NumType=Card
PART	PART
PRON	PRON
PRON-PronType=Prs	PRON-PronType=Prs
PRON-Poss=Yes|PronType=Prs	PRON-Poss=Yes|PronType=Prs
PRON-PronType=Rel	PRON-PronType=Rel
PRON-PronType=Rel	PRON-PronType=Rel
PRON-PronType=Int	PRON-PronType=Int
PROPN-Number=Sing	PROPN-Number=Sing
PROPN-Number=Plur	PROPN-Number=Plur
SYM	SYM
VERB	VERB
VERB-VerbForm=Inf	VERB-VerbForm=Inf
VERB-Mood=Ind|Tense=Past|VerbForm=Fin	VERB-Mood=Ind|Tense=Past|VerbForm=Fin
VERB-VerbForm=Ger	VERB-VerbForm=Ger
VERB-Tense=Past|VerbForm=Part	VERB-Tense=Past|VerbForm=Part
VERB-Mood=Ind|Tense=Pres|VerbForm=Fin	VERB-Mood=Ind|Tense=Pres|VerbForm=Fin
VERB-Mood=Ind|Number=Sing|Person=3|Tense=Pres|VerbForm=Fin	VERB-Mood=Ind|Number=Sing|Person=3|Tense=Pres|VerbForm=Fin
X	X
X-Foreign=Yes	X-Foreign=Yes
